"filename", "language", "JavaScript", "JSON", "JSON with Comments", "Markdown", "TypeScript", "comment", "blank", "total"
"/Users/imsunil/projects/unboxedkart/development/user/server/.eslintrc.js", "JavaScript", 24, 0, 0, 0, 0, 0, 1, 25
"/Users/imsunil/projects/unboxedkart/development/user/server/.prettierrc", "JSON", 0, 5, 0, 0, 0, 0, 0, 5
"/Users/imsunil/projects/unboxedkart/development/user/server/README.md", "Markdown", 0, 0, 0, 51, 0, 2, 21, 74
"/Users/imsunil/projects/unboxedkart/development/user/server/dist/addresses/addresses.controller.d.ts", "TypeScript", 0, 0, 0, 0, 15, 3, 1, 19
"/Users/imsunil/projects/unboxedkart/development/user/server/dist/addresses/addresses.controller.js", "JavaScript", 81, 0, 0, 0, 0, 1, 0, 82
"/Users/imsunil/projects/unboxedkart/development/user/server/dist/addresses/addresses.module.d.ts", "TypeScript", 0, 0, 0, 0, 2, 0, 1, 3
"/Users/imsunil/projects/unboxedkart/development/user/server/dist/addresses/addresses.module.js", "JavaScript", 27, 0, 0, 0, 0, 1, 0, 28
"/Users/imsunil/projects/unboxedkart/development/user/server/dist/addresses/addresses.service.d.ts", "TypeScript", 0, 0, 0, 0, 15, 0, 1, 16
"/Users/imsunil/projects/unboxedkart/development/user/server/dist/addresses/addresses.service.js", "JavaScript", 54, 0, 0, 0, 0, 1, 0, 55
"/Users/imsunil/projects/unboxedkart/development/user/server/dist/addresses/dto/add-address.dto.d.ts", "TypeScript", 0, 0, 0, 0, 13, 0, 1, 14
"/Users/imsunil/projects/unboxedkart/development/user/server/dist/addresses/dto/add-address.dto.js", "JavaScript", 72, 0, 0, 0, 0, 1, 0, 73
"/Users/imsunil/projects/unboxedkart/development/user/server/dist/addresses/dto/address.dto.d.ts", "TypeScript", 0, 0, 0, 0, 12, 0, 1, 13
"/Users/imsunil/projects/unboxedkart/development/user/server/dist/addresses/dto/address.dto.js", "JavaScript", 67, 0, 0, 0, 0, 1, 0, 68
"/Users/imsunil/projects/unboxedkart/development/user/server/dist/addresses/dto/index.d.ts", "TypeScript", 0, 0, 0, 0, 3, 0, 1, 4
"/Users/imsunil/projects/unboxedkart/development/user/server/dist/addresses/dto/index.js", "JavaScript", 15, 0, 0, 0, 0, 1, 0, 16
"/Users/imsunil/projects/unboxedkart/development/user/server/dist/addresses/dto/update-address.dto.d.ts", "TypeScript", 0, 0, 0, 0, 14, 0, 1, 15
"/Users/imsunil/projects/unboxedkart/development/user/server/dist/addresses/dto/update-address.dto.js", "JavaScript", 78, 0, 0, 0, 0, 1, 0, 79
"/Users/imsunil/projects/unboxedkart/development/user/server/dist/app-version/app-version.controller.d.ts", "TypeScript", 0, 0, 0, 0, 10, 3, 1, 14
"/Users/imsunil/projects/unboxedkart/development/user/server/dist/app-version/app-version.controller.js", "JavaScript", 47, 0, 0, 0, 0, 1, 0, 48
"/Users/imsunil/projects/unboxedkart/development/user/server/dist/app-version/app-version.module.d.ts", "TypeScript", 0, 0, 0, 0, 2, 0, 1, 3
"/Users/imsunil/projects/unboxedkart/development/user/server/dist/app-version/app-version.module.js", "JavaScript", 28, 0, 0, 0, 0, 1, 0, 29
"/Users/imsunil/projects/unboxedkart/development/user/server/dist/app-version/app-version.service.d.ts", "TypeScript", 0, 0, 0, 0, 11, 2, 1, 14
"/Users/imsunil/projects/unboxedkart/development/user/server/dist/app-version/app-version.service.js", "JavaScript", 44, 0, 0, 0, 0, 1, 0, 45
"/Users/imsunil/projects/unboxedkart/development/user/server/dist/app-version/dto/create-app-version.dto.d.ts", "TypeScript", 0, 0, 0, 0, 6, 0, 1, 7
"/Users/imsunil/projects/unboxedkart/development/user/server/dist/app-version/dto/create-app-version.dto.js", "JavaScript", 36, 0, 0, 0, 0, 1, 0, 37
"/Users/imsunil/projects/unboxedkart/development/user/server/dist/app-version/entities/app-version.entity.d.ts", "TypeScript", 0, 0, 0, 0, 2, 0, 1, 3
"/Users/imsunil/projects/unboxedkart/development/user/server/dist/app-version/entities/app-version.entity.js", "JavaScript", 6, 0, 0, 0, 0, 1, 0, 7
"/Users/imsunil/projects/unboxedkart/development/user/server/dist/app.controller.d.ts", "TypeScript", 0, 0, 0, 0, 6, 0, 1, 7
"/Users/imsunil/projects/unboxedkart/development/user/server/dist/app.controller.js", "JavaScript", 33, 0, 0, 0, 0, 1, 0, 34
"/Users/imsunil/projects/unboxedkart/development/user/server/dist/app.module.d.ts", "TypeScript", 0, 0, 0, 0, 2, 0, 1, 3
"/Users/imsunil/projects/unboxedkart/development/user/server/dist/app.module.js", "JavaScript", 77, 0, 0, 0, 0, 1, 0, 78
"/Users/imsunil/projects/unboxedkart/development/user/server/dist/app.service.d.ts", "TypeScript", 0, 0, 0, 0, 3, 0, 1, 4
"/Users/imsunil/projects/unboxedkart/development/user/server/dist/app.service.js", "JavaScript", 19, 0, 0, 0, 0, 1, 0, 20
"/Users/imsunil/projects/unboxedkart/development/user/server/dist/auth/auth.controller.d.ts", "TypeScript", 0, 0, 0, 0, 57, 0, 1, 58
"/Users/imsunil/projects/unboxedkart/development/user/server/dist/auth/auth.controller.js", "JavaScript", 134, 0, 0, 0, 0, 1, 0, 135
"/Users/imsunil/projects/unboxedkart/development/user/server/dist/auth/auth.module.d.ts", "TypeScript", 0, 0, 0, 0, 2, 0, 1, 3
"/Users/imsunil/projects/unboxedkart/development/user/server/dist/auth/auth.module.js", "JavaScript", 52, 0, 0, 0, 0, 1, 0, 53
"/Users/imsunil/projects/unboxedkart/development/user/server/dist/auth/auth.service.d.ts", "TypeScript", 0, 0, 0, 0, 76, 0, 1, 77
"/Users/imsunil/projects/unboxedkart/development/user/server/dist/auth/auth.service.js", "JavaScript", 350, 0, 0, 0, 0, 1, 0, 351
"/Users/imsunil/projects/unboxedkart/development/user/server/dist/auth/dto/login.dto.d.ts", "TypeScript", 0, 0, 0, 0, 5, 0, 1, 6
"/Users/imsunil/projects/unboxedkart/development/user/server/dist/auth/dto/login.dto.js", "JavaScript", 31, 0, 0, 0, 0, 1, 0, 32
"/Users/imsunil/projects/unboxedkart/development/user/server/dist/auth/dto/sign-up.dto.d.ts", "TypeScript", 0, 0, 0, 0, 8, 0, 1, 9
"/Users/imsunil/projects/unboxedkart/development/user/server/dist/auth/dto/sign-up.dto.js", "JavaScript", 46, 0, 0, 0, 0, 1, 0, 47
"/Users/imsunil/projects/unboxedkart/development/user/server/dist/auth/jwt-strategies/jwt-auth.guard.d.ts", "TypeScript", 0, 0, 0, 0, 4, 0, 1, 5
"/Users/imsunil/projects/unboxedkart/development/user/server/dist/auth/jwt-strategies/jwt-auth.guard.js", "JavaScript", 17, 0, 0, 0, 0, 1, 0, 18
"/Users/imsunil/projects/unboxedkart/development/user/server/dist/auth/jwt-strategies/jwt-refresh-auth.guard.d.ts", "TypeScript", 0, 0, 0, 0, 4, 0, 1, 5
"/Users/imsunil/projects/unboxedkart/development/user/server/dist/auth/jwt-strategies/jwt-refresh-auth.guard.js", "JavaScript", 17, 0, 0, 0, 0, 1, 0, 18
"/Users/imsunil/projects/unboxedkart/development/user/server/dist/auth/jwt-strategies/jwt-refresh.strategy.d.ts", "TypeScript", 0, 0, 0, 0, 9, 0, 1, 10
"/Users/imsunil/projects/unboxedkart/development/user/server/dist/auth/jwt-strategies/jwt-refresh.strategy.js", "JavaScript", 35, 0, 0, 0, 0, 1, 0, 36
"/Users/imsunil/projects/unboxedkart/development/user/server/dist/auth/jwt-strategies/jwt.strategy.d.ts", "TypeScript", 0, 0, 0, 0, 9, 0, 1, 10
"/Users/imsunil/projects/unboxedkart/development/user/server/dist/auth/jwt-strategies/jwt.strategy.js", "JavaScript", 35, 0, 0, 0, 0, 1, 0, 36
"/Users/imsunil/projects/unboxedkart/development/user/server/dist/carousel-items/carousel-items.controller.d.ts", "TypeScript", 0, 0, 0, 0, 24, 3, 1, 28
"/Users/imsunil/projects/unboxedkart/development/user/server/dist/carousel-items/carousel-items.controller.js", "JavaScript", 107, 0, 0, 0, 0, 1, 0, 108
"/Users/imsunil/projects/unboxedkart/development/user/server/dist/carousel-items/carousel-items.module.d.ts", "TypeScript", 0, 0, 0, 0, 2, 0, 1, 3
"/Users/imsunil/projects/unboxedkart/development/user/server/dist/carousel-items/carousel-items.module.js", "JavaScript", 28, 0, 0, 0, 0, 1, 0, 29
"/Users/imsunil/projects/unboxedkart/development/user/server/dist/carousel-items/carousel-items.service.d.ts", "TypeScript", 0, 0, 0, 0, 32, 2, 1, 35
"/Users/imsunil/projects/unboxedkart/development/user/server/dist/carousel-items/carousel-items.service.js", "JavaScript", 162, 0, 0, 0, 0, 1, 0, 163
"/Users/imsunil/projects/unboxedkart/development/user/server/dist/carousel-items/dto/create-carousel-item.dto.d.ts", "TypeScript", 0, 0, 0, 0, 15, 0, 1, 16
"/Users/imsunil/projects/unboxedkart/development/user/server/dist/carousel-items/dto/create-carousel-item.dto.js", "JavaScript", 82, 0, 0, 0, 0, 1, 0, 83
"/Users/imsunil/projects/unboxedkart/development/user/server/dist/carousel-items/dto/update-carousel-item.dto.d.ts", "TypeScript", 0, 0, 0, 0, 5, 0, 1, 6
"/Users/imsunil/projects/unboxedkart/development/user/server/dist/carousel-items/dto/update-carousel-item.dto.js", "JavaScript", 8, 0, 0, 0, 0, 1, 0, 9
"/Users/imsunil/projects/unboxedkart/development/user/server/dist/carousel-items/entities/carousel-item.entity.d.ts", "TypeScript", 0, 0, 0, 0, 0, 0, 1, 1
"/Users/imsunil/projects/unboxedkart/development/user/server/dist/carousel-items/entities/carousel-item.entity.js", "JavaScript", 0, 0, 0, 0, 0, 1, 0, 1
"/Users/imsunil/projects/unboxedkart/development/user/server/dist/cart/cart.controller.d.ts", "TypeScript", 0, 0, 0, 0, 14, 0, 1, 15
"/Users/imsunil/projects/unboxedkart/development/user/server/dist/cart/cart.controller.js", "JavaScript", 121, 0, 0, 0, 0, 1, 0, 122
"/Users/imsunil/projects/unboxedkart/development/user/server/dist/cart/cart.module.d.ts", "TypeScript", 0, 0, 0, 0, 2, 0, 1, 3
"/Users/imsunil/projects/unboxedkart/development/user/server/dist/cart/cart.module.js", "JavaScript", 35, 0, 0, 0, 0, 1, 0, 36
"/Users/imsunil/projects/unboxedkart/development/user/server/dist/cart/cart.service.d.ts", "TypeScript", 0, 0, 0, 0, 21, 0, 1, 22
"/Users/imsunil/projects/unboxedkart/development/user/server/dist/cart/cart.service.js", "JavaScript", 168, 0, 0, 0, 0, 1, 0, 169
"/Users/imsunil/projects/unboxedkart/development/user/server/dist/cart/dto/add-cart-item.dto.d.ts", "TypeScript", 0, 0, 0, 0, 4, 0, 1, 5
"/Users/imsunil/projects/unboxedkart/development/user/server/dist/cart/dto/add-cart-item.dto.js", "JavaScript", 26, 0, 0, 0, 0, 1, 0, 27
"/Users/imsunil/projects/unboxedkart/development/user/server/dist/cart/dto/update-cart-item.dto.d.ts", "TypeScript", 0, 0, 0, 0, 4, 0, 1, 5
"/Users/imsunil/projects/unboxedkart/development/user/server/dist/cart/dto/update-cart-item.dto.js", "JavaScript", 27, 0, 0, 0, 0, 1, 0, 28
"/Users/imsunil/projects/unboxedkart/development/user/server/dist/coupons copy/coupons.controller.d.ts", "TypeScript", 0, 0, 0, 0, 26, 3, 1, 30
"/Users/imsunil/projects/unboxedkart/development/user/server/dist/coupons copy/coupons.controller.js", "JavaScript", 70, 0, 0, 0, 0, 1, 0, 71
"/Users/imsunil/projects/unboxedkart/development/user/server/dist/coupons copy/coupons.module.d.ts", "TypeScript", 0, 0, 0, 0, 2, 0, 1, 3
"/Users/imsunil/projects/unboxedkart/development/user/server/dist/coupons copy/coupons.module.js", "JavaScript", 36, 0, 0, 0, 0, 1, 0, 37
"/Users/imsunil/projects/unboxedkart/development/user/server/dist/coupons copy/coupons.service.d.ts", "TypeScript", 0, 0, 0, 0, 40, 2, 1, 43
"/Users/imsunil/projects/unboxedkart/development/user/server/dist/coupons copy/coupons.service.js", "JavaScript", 155, 0, 0, 0, 0, 1, 0, 156
"/Users/imsunil/projects/unboxedkart/development/user/server/dist/coupons/coupons.controller.d.ts", "TypeScript", 0, 0, 0, 0, 26, 3, 1, 30
"/Users/imsunil/projects/unboxedkart/development/user/server/dist/coupons/coupons.controller.js", "JavaScript", 70, 0, 0, 0, 0, 1, 0, 71
"/Users/imsunil/projects/unboxedkart/development/user/server/dist/coupons/coupons.module.d.ts", "TypeScript", 0, 0, 0, 0, 2, 0, 1, 3
"/Users/imsunil/projects/unboxedkart/development/user/server/dist/coupons/coupons.module.js", "JavaScript", 36, 0, 0, 0, 0, 1, 0, 37
"/Users/imsunil/projects/unboxedkart/development/user/server/dist/coupons/coupons.service.d.ts", "TypeScript", 0, 0, 0, 0, 40, 2, 1, 43
"/Users/imsunil/projects/unboxedkart/development/user/server/dist/coupons/coupons.service.js", "JavaScript", 155, 0, 0, 0, 0, 1, 0, 156
"/Users/imsunil/projects/unboxedkart/development/user/server/dist/exceptions/http-exception.filter.d.ts", "TypeScript", 0, 0, 0, 0, 4, 0, 1, 5
"/Users/imsunil/projects/unboxedkart/development/user/server/dist/exceptions/http-exception.filter.js", "JavaScript", 27, 0, 0, 0, 0, 1, 0, 28
"/Users/imsunil/projects/unboxedkart/development/user/server/dist/faqs/dto/create-faq.dto.d.ts", "TypeScript", 0, 0, 0, 0, 4, 0, 1, 5
"/Users/imsunil/projects/unboxedkart/development/user/server/dist/faqs/dto/create-faq.dto.js", "JavaScript", 26, 0, 0, 0, 0, 1, 0, 27
"/Users/imsunil/projects/unboxedkart/development/user/server/dist/faqs/faqs.controller.d.ts", "TypeScript", 0, 0, 0, 0, 10, 0, 1, 11
"/Users/imsunil/projects/unboxedkart/development/user/server/dist/faqs/faqs.controller.js", "JavaScript", 59, 0, 0, 0, 0, 1, 0, 60
"/Users/imsunil/projects/unboxedkart/development/user/server/dist/faqs/faqs.module.d.ts", "TypeScript", 0, 0, 0, 0, 2, 0, 1, 3
"/Users/imsunil/projects/unboxedkart/development/user/server/dist/faqs/faqs.module.js", "JavaScript", 32, 0, 0, 0, 0, 1, 0, 33
"/Users/imsunil/projects/unboxedkart/development/user/server/dist/faqs/faqs.service.d.ts", "TypeScript", 0, 0, 0, 0, 15, 2, 1, 18
"/Users/imsunil/projects/unboxedkart/development/user/server/dist/faqs/faqs.service.js", "JavaScript", 47, 0, 0, 0, 0, 1, 0, 48
"/Users/imsunil/projects/unboxedkart/development/user/server/dist/favorites/favorites.controller.d.ts", "TypeScript", 0, 0, 0, 0, 11, 0, 1, 12
"/Users/imsunil/projects/unboxedkart/development/user/server/dist/favorites/favorites.controller.js", "JavaScript", 68, 0, 0, 0, 0, 1, 0, 69
"/Users/imsunil/projects/unboxedkart/development/user/server/dist/favorites/favorites.module.d.ts", "TypeScript", 0, 0, 0, 0, 2, 0, 1, 3
"/Users/imsunil/projects/unboxedkart/development/user/server/dist/favorites/favorites.module.js", "JavaScript", 33, 0, 0, 0, 0, 1, 0, 34
"/Users/imsunil/projects/unboxedkart/development/user/server/dist/favorites/favorites.service.d.ts", "TypeScript", 0, 0, 0, 0, 16, 0, 1, 17
"/Users/imsunil/projects/unboxedkart/development/user/server/dist/favorites/favorites.service.js", "JavaScript", 106, 0, 0, 0, 0, 1, 0, 107
"/Users/imsunil/projects/unboxedkart/development/user/server/dist/local-inventory/dto/add-product.dto.d.ts", "TypeScript", 0, 0, 0, 0, 12, 0, 1, 13
"/Users/imsunil/projects/unboxedkart/development/user/server/dist/local-inventory/dto/add-product.dto.js", "JavaScript", 61, 0, 0, 0, 0, 1, 0, 62
"/Users/imsunil/projects/unboxedkart/development/user/server/dist/local-inventory/dto/add-seller.dto.d.ts", "TypeScript", 0, 0, 0, 0, 8, 0, 1, 9
"/Users/imsunil/projects/unboxedkart/development/user/server/dist/local-inventory/dto/add-seller.dto.js", "JavaScript", 31, 0, 0, 0, 0, 1, 0, 32
"/Users/imsunil/projects/unboxedkart/development/user/server/dist/local-inventory/dto/sell-product.dto.d.ts", "TypeScript", 0, 0, 0, 0, 10, 0, 1, 11
"/Users/imsunil/projects/unboxedkart/development/user/server/dist/local-inventory/dto/sell-product.dto.js", "JavaScript", 44, 0, 0, 0, 0, 1, 0, 45
"/Users/imsunil/projects/unboxedkart/development/user/server/dist/local-inventory/local-inventory.controller.d.ts", "TypeScript", 0, 0, 0, 0, 36, 4, 1, 41
"/Users/imsunil/projects/unboxedkart/development/user/server/dist/local-inventory/local-inventory.controller.js", "JavaScript", 220, 0, 0, 0, 0, 1, 0, 221
"/Users/imsunil/projects/unboxedkart/development/user/server/dist/local-inventory/local-inventory.module.d.ts", "TypeScript", 0, 0, 0, 0, 2, 0, 1, 3
"/Users/imsunil/projects/unboxedkart/development/user/server/dist/local-inventory/local-inventory.module.js", "JavaScript", 43, 0, 0, 0, 0, 1, 0, 44
"/Users/imsunil/projects/unboxedkart/development/user/server/dist/local-inventory/local-inventory.service.d.ts", "TypeScript", 0, 0, 0, 0, 38, 2, 1, 41
"/Users/imsunil/projects/unboxedkart/development/user/server/dist/local-inventory/local-inventory.service.js", "JavaScript", 218, 0, 0, 0, 0, 1, 0, 219
"/Users/imsunil/projects/unboxedkart/development/user/server/dist/mail/mail.module.d.ts", "TypeScript", 0, 0, 0, 0, 2, 0, 1, 3
"/Users/imsunil/projects/unboxedkart/development/user/server/dist/mail/mail.module.js", "JavaScript", 37, 0, 0, 0, 0, 1, 0, 38
"/Users/imsunil/projects/unboxedkart/development/user/server/dist/mail/mail.service.d.ts", "TypeScript", 0, 0, 0, 0, 2, 0, 1, 3
"/Users/imsunil/projects/unboxedkart/development/user/server/dist/mail/mail.service.js", "JavaScript", 16, 0, 0, 0, 0, 1, 0, 17
"/Users/imsunil/projects/unboxedkart/development/user/server/dist/main.d.ts", "TypeScript", 0, 0, 0, 0, 1, 0, 1, 2
"/Users/imsunil/projects/unboxedkart/development/user/server/dist/main.js", "JavaScript", 17, 0, 0, 0, 0, 1, 0, 18
"/Users/imsunil/projects/unboxedkart/development/user/server/dist/models/Tracking-notification.model.d.ts", "TypeScript", 0, 0, 0, 0, 12, 0, 1, 13
"/Users/imsunil/projects/unboxedkart/development/user/server/dist/models/Tracking-notification.model.js", "JavaScript", 14, 0, 0, 0, 0, 1, 0, 15
"/Users/imsunil/projects/unboxedkart/development/user/server/dist/models/address.model.d.ts", "TypeScript", 0, 0, 0, 0, 15, 0, 1, 16
"/Users/imsunil/projects/unboxedkart/development/user/server/dist/models/address.model.js", "JavaScript", 18, 0, 0, 0, 0, 1, 0, 19
"/Users/imsunil/projects/unboxedkart/development/user/server/dist/models/admin/admin.model.d.ts", "TypeScript", 0, 0, 0, 0, 10, 0, 1, 11
"/Users/imsunil/projects/unboxedkart/development/user/server/dist/models/admin/admin.model.js", "JavaScript", 12, 0, 0, 0, 0, 1, 0, 13
"/Users/imsunil/projects/unboxedkart/development/user/server/dist/models/admin/notification.model.d.ts", "TypeScript", 0, 0, 0, 0, 9, 0, 1, 10
"/Users/imsunil/projects/unboxedkart/development/user/server/dist/models/admin/notification.model.js", "JavaScript", 12, 0, 0, 0, 0, 1, 0, 13
"/Users/imsunil/projects/unboxedkart/development/user/server/dist/models/admin/seller.model.d.ts", "TypeScript", 0, 0, 0, 0, 14, 0, 1, 15
"/Users/imsunil/projects/unboxedkart/development/user/server/dist/models/admin/seller.model.js", "JavaScript", 16, 0, 0, 0, 0, 1, 0, 17
"/Users/imsunil/projects/unboxedkart/development/user/server/dist/models/answer.model.d.ts", "TypeScript", 0, 0, 0, 0, 21, 0, 1, 22
"/Users/imsunil/projects/unboxedkart/development/user/server/dist/models/answer.model.js", "JavaScript", 25, 0, 0, 0, 0, 1, 0, 26
"/Users/imsunil/projects/unboxedkart/development/user/server/dist/models/app_version.model.d.ts", "TypeScript", 0, 0, 0, 0, 8, 0, 1, 9
"/Users/imsunil/projects/unboxedkart/development/user/server/dist/models/app_version.model.js", "JavaScript", 11, 0, 0, 0, 0, 1, 0, 12
"/Users/imsunil/projects/unboxedkart/development/user/server/dist/models/carousel_item.model.d.ts", "TypeScript", 0, 0, 0, 0, 25, 0, 1, 26
"/Users/imsunil/projects/unboxedkart/development/user/server/dist/models/carousel_item.model.js", "JavaScript", 28, 0, 0, 0, 0, 1, 0, 29
"/Users/imsunil/projects/unboxedkart/development/user/server/dist/models/cart-item.model.d.ts", "TypeScript", 0, 0, 0, 0, 8, 0, 1, 9
"/Users/imsunil/projects/unboxedkart/development/user/server/dist/models/cart-item.model.js", "JavaScript", 10, 0, 0, 0, 0, 1, 0, 11
"/Users/imsunil/projects/unboxedkart/development/user/server/dist/models/coupon.model.d.ts", "TypeScript", 0, 0, 0, 0, 53, 0, 1, 54
"/Users/imsunil/projects/unboxedkart/development/user/server/dist/models/coupon.model.js", "JavaScript", 39, 0, 0, 0, 0, 1, 0, 40
"/Users/imsunil/projects/unboxedkart/development/user/server/dist/models/faq.model.d.ts", "TypeScript", 0, 0, 0, 0, 6, 0, 1, 7
"/Users/imsunil/projects/unboxedkart/development/user/server/dist/models/faq.model.js", "JavaScript", 9, 0, 0, 0, 0, 1, 0, 10
"/Users/imsunil/projects/unboxedkart/development/user/server/dist/models/favorite.model.d.ts", "TypeScript", 0, 0, 0, 0, 7, 0, 1, 8
"/Users/imsunil/projects/unboxedkart/development/user/server/dist/models/favorite.model.js", "JavaScript", 9, 0, 0, 0, 0, 1, 0, 10
"/Users/imsunil/projects/unboxedkart/development/user/server/dist/models/item-purchased-user.model.d.ts", "TypeScript", 0, 0, 0, 0, 15, 0, 1, 16
"/Users/imsunil/projects/unboxedkart/development/user/server/dist/models/item-purchased-user.model.js", "JavaScript", 17, 0, 0, 0, 0, 1, 0, 18
"/Users/imsunil/projects/unboxedkart/development/user/server/dist/models/local_inventory/agent.model.d.ts", "TypeScript", 0, 0, 0, 0, 10, 0, 1, 11
"/Users/imsunil/projects/unboxedkart/development/user/server/dist/models/local_inventory/agent.model.js", "JavaScript", 12, 0, 0, 0, 0, 1, 0, 13
"/Users/imsunil/projects/unboxedkart/development/user/server/dist/models/local_inventory/buyer.model.d.ts", "TypeScript", 0, 0, 0, 0, 10, 0, 1, 11
"/Users/imsunil/projects/unboxedkart/development/user/server/dist/models/local_inventory/buyer.model.js", "JavaScript", 12, 0, 0, 0, 0, 1, 0, 13
"/Users/imsunil/projects/unboxedkart/development/user/server/dist/models/local_inventory/customer.model.d.ts", "TypeScript", 0, 0, 0, 0, 13, 0, 1, 14
"/Users/imsunil/projects/unboxedkart/development/user/server/dist/models/local_inventory/customer.model.js", "JavaScript", 15, 0, 0, 0, 0, 1, 0, 16
"/Users/imsunil/projects/unboxedkart/development/user/server/dist/models/local_inventory/notification.model.d.ts", "TypeScript", 0, 0, 0, 0, 8, 0, 1, 9
"/Users/imsunil/projects/unboxedkart/development/user/server/dist/models/local_inventory/notification.model.js", "JavaScript", 10, 0, 0, 0, 0, 1, 0, 11
"/Users/imsunil/projects/unboxedkart/development/user/server/dist/models/local_inventory/product.model.d.ts", "TypeScript", 0, 0, 0, 0, 56, 0, 1, 57
"/Users/imsunil/projects/unboxedkart/development/user/server/dist/models/local_inventory/product.model.js", "JavaScript", 61, 0, 0, 0, 0, 1, 0, 62
"/Users/imsunil/projects/unboxedkart/development/user/server/dist/models/local_inventory/purchased-item.model.d.ts", "TypeScript", 0, 0, 0, 0, 13, 0, 1, 14
"/Users/imsunil/projects/unboxedkart/development/user/server/dist/models/local_inventory/purchased-item.model.js", "JavaScript", 15, 0, 0, 0, 0, 1, 0, 16
"/Users/imsunil/projects/unboxedkart/development/user/server/dist/models/local_inventory/vendor.model.d.ts", "TypeScript", 0, 0, 0, 0, 11, 0, 1, 12
"/Users/imsunil/projects/unboxedkart/development/user/server/dist/models/local_inventory/vendor.model.js", "JavaScript", 13, 0, 0, 0, 0, 1, 0, 14
"/Users/imsunil/projects/unboxedkart/development/user/server/dist/models/notification.model.d.ts", "TypeScript", 0, 0, 0, 0, 11, 0, 1, 12
"/Users/imsunil/projects/unboxedkart/development/user/server/dist/models/notification.model.js", "JavaScript", 13, 0, 0, 0, 0, 1, 0, 14
"/Users/imsunil/projects/unboxedkart/development/user/server/dist/models/order.model.d.ts", "TypeScript", 0, 0, 0, 0, 73, 0, 1, 74
"/Users/imsunil/projects/unboxedkart/development/user/server/dist/models/order.model.js", "JavaScript", 84, 0, 0, 0, 0, 1, 0, 85
"/Users/imsunil/projects/unboxedkart/development/user/server/dist/models/orderItem.model.d.ts", "TypeScript", 0, 0, 0, 0, 59, 0, 1, 60
"/Users/imsunil/projects/unboxedkart/development/user/server/dist/models/orderItem.model.js", "JavaScript", 69, 0, 0, 0, 0, 1, 0, 70
"/Users/imsunil/projects/unboxedkart/development/user/server/dist/models/order_summary.model.d.ts", "TypeScript", 0, 0, 0, 0, 41, 0, 1, 42
"/Users/imsunil/projects/unboxedkart/development/user/server/dist/models/order_summary.model.js", "JavaScript", 43, 0, 0, 0, 0, 1, 0, 44
"/Users/imsunil/projects/unboxedkart/development/user/server/dist/models/ordered_service.model.d.ts", "TypeScript", 0, 0, 0, 0, 7, 0, 1, 8
"/Users/imsunil/projects/unboxedkart/development/user/server/dist/models/ordered_service.model.js", "JavaScript", 9, 0, 0, 0, 0, 1, 0, 10
"/Users/imsunil/projects/unboxedkart/development/user/server/dist/models/payment.model.d.ts", "TypeScript", 0, 0, 0, 0, 15, 0, 1, 16
"/Users/imsunil/projects/unboxedkart/development/user/server/dist/models/payment.model.js", "JavaScript", 17, 0, 0, 0, 0, 1, 0, 18
"/Users/imsunil/projects/unboxedkart/development/user/server/dist/models/product-description.d.ts", "TypeScript", 0, 0, 0, 0, 6, 0, 1, 7
"/Users/imsunil/projects/unboxedkart/development/user/server/dist/models/product-description.js", "JavaScript", 8, 0, 0, 0, 0, 1, 0, 9
"/Users/imsunil/projects/unboxedkart/development/user/server/dist/models/product-specs.d.ts", "TypeScript", 0, 0, 0, 0, 11, 0, 1, 12
"/Users/imsunil/projects/unboxedkart/development/user/server/dist/models/product-specs.js", "JavaScript", 13, 0, 0, 0, 0, 1, 0, 14
"/Users/imsunil/projects/unboxedkart/development/user/server/dist/models/product.model.d.ts", "TypeScript", 0, 0, 0, 0, 61, 0, 1, 62
"/Users/imsunil/projects/unboxedkart/development/user/server/dist/models/product.model.js", "JavaScript", 63, 0, 0, 0, 0, 1, 0, 64
"/Users/imsunil/projects/unboxedkart/development/user/server/dist/models/product_data.model.d.ts", "TypeScript", 0, 0, 0, 0, 56, 0, 1, 57
"/Users/imsunil/projects/unboxedkart/development/user/server/dist/models/product_data.model.js", "JavaScript", 58, 0, 0, 0, 0, 1, 0, 59
"/Users/imsunil/projects/unboxedkart/development/user/server/dist/models/product_images.model.d.ts", "TypeScript", 0, 0, 0, 0, 10, 0, 1, 11
"/Users/imsunil/projects/unboxedkart/development/user/server/dist/models/product_images.model.js", "JavaScript", 12, 0, 0, 0, 0, 1, 0, 13
"/Users/imsunil/projects/unboxedkart/development/user/server/dist/models/q_and_a.model.d.ts", "TypeScript", 0, 0, 0, 0, 25, 0, 1, 26
"/Users/imsunil/projects/unboxedkart/development/user/server/dist/models/q_and_a.model.js", "JavaScript", 32, 0, 0, 0, 0, 1, 0, 33
"/Users/imsunil/projects/unboxedkart/development/user/server/dist/models/question.model.d.ts", "TypeScript", 0, 0, 0, 0, 20, 0, 1, 21
"/Users/imsunil/projects/unboxedkart/development/user/server/dist/models/question.model.js", "JavaScript", 22, 0, 0, 0, 0, 1, 0, 23
"/Users/imsunil/projects/unboxedkart/development/user/server/dist/models/referral_order.d.ts", "TypeScript", 0, 0, 0, 0, 25, 0, 1, 26
"/Users/imsunil/projects/unboxedkart/development/user/server/dist/models/referral_order.js", "JavaScript", 27, 0, 0, 0, 0, 1, 0, 28
"/Users/imsunil/projects/unboxedkart/development/user/server/dist/models/refresh-token.model.d.ts", "TypeScript", 0, 0, 0, 0, 7, 0, 1, 8
"/Users/imsunil/projects/unboxedkart/development/user/server/dist/models/refresh-token.model.js", "JavaScript", 9, 0, 0, 0, 0, 1, 0, 10
"/Users/imsunil/projects/unboxedkart/development/user/server/dist/models/review.model.d.ts", "TypeScript", 0, 0, 0, 0, 15, 0, 1, 16
"/Users/imsunil/projects/unboxedkart/development/user/server/dist/models/review.model.js", "JavaScript", 17, 0, 0, 0, 0, 1, 0, 18
"/Users/imsunil/projects/unboxedkart/development/user/server/dist/models/reviews_data.model.d.ts", "TypeScript", 0, 0, 0, 0, 13, 0, 1, 14
"/Users/imsunil/projects/unboxedkart/development/user/server/dist/models/reviews_data.model.js", "JavaScript", 15, 0, 0, 0, 0, 1, 0, 16
"/Users/imsunil/projects/unboxedkart/development/user/server/dist/models/save_to_later.model.d.ts", "TypeScript", 0, 0, 0, 0, 8, 0, 1, 9
"/Users/imsunil/projects/unboxedkart/development/user/server/dist/models/save_to_later.model.js", "JavaScript", 10, 0, 0, 0, 0, 1, 0, 11
"/Users/imsunil/projects/unboxedkart/development/user/server/dist/models/search_term.d.ts", "TypeScript", 0, 0, 0, 0, 8, 0, 1, 9
"/Users/imsunil/projects/unboxedkart/development/user/server/dist/models/search_term.js", "JavaScript", 10, 0, 0, 0, 0, 1, 0, 11
"/Users/imsunil/projects/unboxedkart/development/user/server/dist/models/service.model.d.ts", "TypeScript", 0, 0, 0, 0, 9, 0, 1, 10
"/Users/imsunil/projects/unboxedkart/development/user/server/dist/models/service.model.js", "JavaScript", 11, 0, 0, 0, 0, 1, 0, 12
"/Users/imsunil/projects/unboxedkart/development/user/server/dist/models/service_order.model.d.ts", "TypeScript", 0, 0, 0, 0, 17, 0, 1, 18
"/Users/imsunil/projects/unboxedkart/development/user/server/dist/models/service_order.model.js", "JavaScript", 20, 0, 0, 0, 0, 1, 0, 21
"/Users/imsunil/projects/unboxedkart/development/user/server/dist/models/store-app/token.model.d.ts", "TypeScript", 0, 0, 0, 0, 24, 0, 1, 25
"/Users/imsunil/projects/unboxedkart/development/user/server/dist/models/store-app/token.model.js", "JavaScript", 27, 0, 0, 0, 0, 1, 0, 28
"/Users/imsunil/projects/unboxedkart/development/user/server/dist/models/store_location.model.d.ts", "TypeScript", 0, 0, 0, 0, 13, 0, 1, 14
"/Users/imsunil/projects/unboxedkart/development/user/server/dist/models/store_location.model.js", "JavaScript", 15, 0, 0, 0, 0, 1, 0, 16
"/Users/imsunil/projects/unboxedkart/development/user/server/dist/models/user.model.d.ts", "TypeScript", 0, 0, 0, 0, 45, 0, 1, 46
"/Users/imsunil/projects/unboxedkart/development/user/server/dist/models/user.model.js", "JavaScript", 40, 0, 0, 0, 0, 1, 0, 41
"/Users/imsunil/projects/unboxedkart/development/user/server/dist/models/user_payment_details.model.d.ts", "TypeScript", 0, 0, 0, 0, 7, 0, 1, 8
"/Users/imsunil/projects/unboxedkart/development/user/server/dist/models/user_payment_details.model.js", "JavaScript", 9, 0, 0, 0, 0, 1, 0, 10
"/Users/imsunil/projects/unboxedkart/development/user/server/dist/models/variants_data.model.d.ts", "TypeScript", 0, 0, 0, 0, 10, 0, 1, 11
"/Users/imsunil/projects/unboxedkart/development/user/server/dist/models/variants_data.model.js", "JavaScript", 12, 0, 0, 0, 0, 1, 0, 13
"/Users/imsunil/projects/unboxedkart/development/user/server/dist/order-summary/dto/add-address.dto.d.ts", "TypeScript", 0, 0, 0, 0, 13, 0, 1, 14
"/Users/imsunil/projects/unboxedkart/development/user/server/dist/order-summary/dto/add-address.dto.js", "JavaScript", 72, 0, 0, 0, 0, 1, 0, 73
"/Users/imsunil/projects/unboxedkart/development/user/server/dist/order-summary/dto/add-selected-store.dto.d.ts", "TypeScript", 0, 0, 0, 0, 16, 0, 1, 17
"/Users/imsunil/projects/unboxedkart/development/user/server/dist/order-summary/dto/add-selected-store.dto.js", "JavaScript", 83, 0, 0, 0, 0, 1, 0, 84
"/Users/imsunil/projects/unboxedkart/development/user/server/dist/order-summary/dto/create-order-summary.dto.d.ts", "TypeScript", 0, 0, 0, 0, 7, 0, 1, 8
"/Users/imsunil/projects/unboxedkart/development/user/server/dist/order-summary/dto/create-order-summary.dto.js", "JavaScript", 26, 0, 0, 0, 0, 1, 0, 27
"/Users/imsunil/projects/unboxedkart/development/user/server/dist/order-summary/dto/update-count.dto.d.ts", "TypeScript", 0, 0, 0, 0, 5, 0, 1, 6
"/Users/imsunil/projects/unboxedkart/development/user/server/dist/order-summary/dto/update-count.dto.js", "JavaScript", 31, 0, 0, 0, 0, 1, 0, 32
"/Users/imsunil/projects/unboxedkart/development/user/server/dist/order-summary/dto/verify-payment.dto.d.ts", "TypeScript", 0, 0, 0, 0, 5, 0, 1, 6
"/Users/imsunil/projects/unboxedkart/development/user/server/dist/order-summary/dto/verify-payment.dto.js", "JavaScript", 31, 0, 0, 0, 0, 1, 0, 32
"/Users/imsunil/projects/unboxedkart/development/user/server/dist/order-summary/order-summary.controller.d.ts", "TypeScript", 0, 0, 0, 0, 55, 0, 1, 56
"/Users/imsunil/projects/unboxedkart/development/user/server/dist/order-summary/order-summary.controller.js", "JavaScript", 178, 0, 0, 0, 0, 1, 0, 179
"/Users/imsunil/projects/unboxedkart/development/user/server/dist/order-summary/order-summary.module.d.ts", "TypeScript", 0, 0, 0, 0, 2, 0, 1, 3
"/Users/imsunil/projects/unboxedkart/development/user/server/dist/order-summary/order-summary.module.js", "JavaScript", 41, 0, 0, 0, 0, 1, 0, 42
"/Users/imsunil/projects/unboxedkart/development/user/server/dist/order-summary/order-summary.service.d.ts", "TypeScript", 0, 0, 0, 0, 73, 0, 1, 74
"/Users/imsunil/projects/unboxedkart/development/user/server/dist/order-summary/order-summary.service.js", "JavaScript", 386, 0, 0, 0, 0, 1, 0, 387
"/Users/imsunil/projects/unboxedkart/development/user/server/dist/orders/dto/cancel-order.dto.d.ts", "TypeScript", 0, 0, 0, 0, 6, 0, 1, 7
"/Users/imsunil/projects/unboxedkart/development/user/server/dist/orders/dto/cancel-order.dto.js", "JavaScript", 36, 0, 0, 0, 0, 1, 0, 37
"/Users/imsunil/projects/unboxedkart/development/user/server/dist/orders/dto/create-order.dto.d.ts", "TypeScript", 0, 0, 0, 0, 3, 0, 1, 4
"/Users/imsunil/projects/unboxedkart/development/user/server/dist/orders/dto/create-order.dto.js", "JavaScript", 21, 0, 0, 0, 0, 1, 0, 22
"/Users/imsunil/projects/unboxedkart/development/user/server/dist/orders/order.unused.service.d.ts", "TypeScript", 0, 0, 0, 0, 0, 0, 1, 1
"/Users/imsunil/projects/unboxedkart/development/user/server/dist/orders/order.unused.service.js", "JavaScript", 0, 0, 0, 0, 0, 1, 0, 1
"/Users/imsunil/projects/unboxedkart/development/user/server/dist/orders/orders.controller.d.ts", "TypeScript", 0, 0, 0, 0, 41, 3, 1, 45
"/Users/imsunil/projects/unboxedkart/development/user/server/dist/orders/orders.controller.js", "JavaScript", 141, 0, 0, 0, 0, 1, 0, 142
"/Users/imsunil/projects/unboxedkart/development/user/server/dist/orders/orders.module.d.ts", "TypeScript", 0, 0, 0, 0, 2, 0, 1, 3
"/Users/imsunil/projects/unboxedkart/development/user/server/dist/orders/orders.module.js", "JavaScript", 53, 0, 0, 0, 0, 1, 0, 54
"/Users/imsunil/projects/unboxedkart/development/user/server/dist/orders/orders.service.d.ts", "TypeScript", 0, 0, 0, 0, 116, 2, 1, 119
"/Users/imsunil/projects/unboxedkart/development/user/server/dist/orders/orders.service.js", "JavaScript", 521, 0, 0, 0, 0, 1, 0, 522
"/Users/imsunil/projects/unboxedkart/development/user/server/dist/product-details/product-details.controller.d.ts", "TypeScript", 0, 0, 0, 0, 16, 3, 1, 20
"/Users/imsunil/projects/unboxedkart/development/user/server/dist/product-details/product-details.controller.js", "JavaScript", 73, 0, 0, 0, 0, 1, 0, 74
"/Users/imsunil/projects/unboxedkart/development/user/server/dist/product-details/product-details.module.d.ts", "TypeScript", 0, 0, 0, 0, 2, 0, 1, 3
"/Users/imsunil/projects/unboxedkart/development/user/server/dist/product-details/product-details.module.js", "JavaScript", 36, 0, 0, 0, 0, 1, 0, 37
"/Users/imsunil/projects/unboxedkart/development/user/server/dist/product-details/product-details.service.d.ts", "TypeScript", 0, 0, 0, 0, 25, 2, 1, 28
"/Users/imsunil/projects/unboxedkart/development/user/server/dist/product-details/product-details.service.js", "JavaScript", 88, 0, 0, 0, 0, 1, 0, 89
"/Users/imsunil/projects/unboxedkart/development/user/server/dist/products/product.module.d.ts", "TypeScript", 0, 0, 0, 0, 2, 0, 1, 3
"/Users/imsunil/projects/unboxedkart/development/user/server/dist/products/product.module.js", "JavaScript", 41, 0, 0, 0, 0, 1, 0, 42
"/Users/imsunil/projects/unboxedkart/development/user/server/dist/products/products.controller.d.ts", "TypeScript", 0, 0, 0, 0, 15, 0, 1, 16
"/Users/imsunil/projects/unboxedkart/development/user/server/dist/products/products.controller.js", "JavaScript", 109, 0, 0, 0, 0, 1, 0, 110
"/Users/imsunil/projects/unboxedkart/development/user/server/dist/products/products.service.d.ts", "TypeScript", 0, 0, 0, 0, 27, 0, 1, 28
"/Users/imsunil/projects/unboxedkart/development/user/server/dist/products/products.service.js", "JavaScript", 352, 0, 0, 0, 0, 1, 0, 353
"/Users/imsunil/projects/unboxedkart/development/user/server/dist/q-and-a/dto/create_answer.dto.d.ts", "TypeScript", 0, 0, 0, 0, 7, 0, 1, 8
"/Users/imsunil/projects/unboxedkart/development/user/server/dist/q-and-a/dto/create_answer.dto.js", "JavaScript", 41, 0, 0, 0, 0, 1, 0, 42
"/Users/imsunil/projects/unboxedkart/development/user/server/dist/q-and-a/dto/create_question.dto.d.ts", "TypeScript", 0, 0, 0, 0, 4, 0, 1, 5
"/Users/imsunil/projects/unboxedkart/development/user/server/dist/q-and-a/dto/create_question.dto.js", "JavaScript", 26, 0, 0, 0, 0, 1, 0, 27
"/Users/imsunil/projects/unboxedkart/development/user/server/dist/q-and-a/q-and-a.controller.d.ts", "TypeScript", 0, 0, 0, 0, 26, 3, 1, 30
"/Users/imsunil/projects/unboxedkart/development/user/server/dist/q-and-a/q-and-a.controller.js", "JavaScript", 138, 0, 0, 0, 0, 1, 0, 139
"/Users/imsunil/projects/unboxedkart/development/user/server/dist/q-and-a/q-and-a.module.d.ts", "TypeScript", 0, 0, 0, 0, 2, 0, 1, 3
"/Users/imsunil/projects/unboxedkart/development/user/server/dist/q-and-a/q-and-a.module.js", "JavaScript", 41, 0, 0, 0, 0, 1, 0, 42
"/Users/imsunil/projects/unboxedkart/development/user/server/dist/q-and-a/q-and-a.service.d.ts", "TypeScript", 0, 0, 0, 0, 38, 2, 1, 41
"/Users/imsunil/projects/unboxedkart/development/user/server/dist/q-and-a/q-and-a.service.js", "JavaScript", 173, 0, 0, 0, 0, 1, 0, 174
"/Users/imsunil/projects/unboxedkart/development/user/server/dist/reviews/dto/create-review.dto.d.ts", "TypeScript", 0, 0, 0, 0, 6, 0, 1, 7
"/Users/imsunil/projects/unboxedkart/development/user/server/dist/reviews/dto/create-review.dto.js", "JavaScript", 38, 0, 0, 0, 0, 1, 0, 39
"/Users/imsunil/projects/unboxedkart/development/user/server/dist/reviews/dto/update-review.dto.d.ts", "TypeScript", 0, 0, 0, 0, 10, 0, 1, 11
"/Users/imsunil/projects/unboxedkart/development/user/server/dist/reviews/dto/update-review.dto.js", "JavaScript", 56, 0, 0, 0, 0, 1, 0, 57
"/Users/imsunil/projects/unboxedkart/development/user/server/dist/reviews/reviews.controller.d.ts", "TypeScript", 0, 0, 0, 0, 29, 3, 1, 33
"/Users/imsunil/projects/unboxedkart/development/user/server/dist/reviews/reviews.controller.js", "JavaScript", 112, 0, 0, 0, 0, 1, 0, 113
"/Users/imsunil/projects/unboxedkart/development/user/server/dist/reviews/reviews.module.d.ts", "TypeScript", 0, 0, 0, 0, 2, 0, 1, 3
"/Users/imsunil/projects/unboxedkart/development/user/server/dist/reviews/reviews.module.js", "JavaScript", 36, 0, 0, 0, 0, 1, 0, 37
"/Users/imsunil/projects/unboxedkart/development/user/server/dist/reviews/reviews.service.d.ts", "TypeScript", 0, 0, 0, 0, 32, 2, 1, 35
"/Users/imsunil/projects/unboxedkart/development/user/server/dist/reviews/reviews.service.js", "JavaScript", 110, 0, 0, 0, 0, 1, 0, 111
"/Users/imsunil/projects/unboxedkart/development/user/server/dist/s3/s3.controller.d.ts", "TypeScript", 0, 0, 0, 0, 5, 0, 1, 6
"/Users/imsunil/projects/unboxedkart/development/user/server/dist/s3/s3.controller.js", "JavaScript", 24, 0, 0, 0, 0, 1, 0, 25
"/Users/imsunil/projects/unboxedkart/development/user/server/dist/s3/s3.module.d.ts", "TypeScript", 0, 0, 0, 0, 2, 0, 1, 3
"/Users/imsunil/projects/unboxedkart/development/user/server/dist/s3/s3.module.js", "JavaScript", 21, 0, 0, 0, 0, 1, 0, 22
"/Users/imsunil/projects/unboxedkart/development/user/server/dist/s3/s3.service.d.ts", "TypeScript", 0, 0, 0, 0, 13, 0, 1, 14
"/Users/imsunil/projects/unboxedkart/development/user/server/dist/s3/s3.service.js", "JavaScript", 76, 0, 0, 0, 0, 1, 0, 77
"/Users/imsunil/projects/unboxedkart/development/user/server/dist/search/dto/add-search-term.dto.d.ts", "TypeScript", 0, 0, 0, 0, 3, 0, 1, 4
"/Users/imsunil/projects/unboxedkart/development/user/server/dist/search/dto/add-search-term.dto.js", "JavaScript", 21, 0, 0, 0, 0, 1, 0, 22
"/Users/imsunil/projects/unboxedkart/development/user/server/dist/search/search.controller.d.ts", "TypeScript", 0, 0, 0, 0, 21, 3, 1, 25
"/Users/imsunil/projects/unboxedkart/development/user/server/dist/search/search.controller.js", "JavaScript", 125, 0, 0, 0, 0, 1, 0, 126
"/Users/imsunil/projects/unboxedkart/development/user/server/dist/search/search.module.d.ts", "TypeScript", 0, 0, 0, 0, 2, 0, 1, 3
"/Users/imsunil/projects/unboxedkart/development/user/server/dist/search/search.module.js", "JavaScript", 33, 0, 0, 0, 0, 1, 0, 34
"/Users/imsunil/projects/unboxedkart/development/user/server/dist/search/search.service.d.ts", "TypeScript", 0, 0, 0, 0, 20, 2, 1, 23
"/Users/imsunil/projects/unboxedkart/development/user/server/dist/search/search.service.js", "JavaScript", 131, 0, 0, 0, 0, 1, 0, 132
"/Users/imsunil/projects/unboxedkart/development/user/server/dist/service/dto/create-service.dto.d.ts", "TypeScript", 0, 0, 0, 0, 14, 0, 1, 15
"/Users/imsunil/projects/unboxedkart/development/user/server/dist/service/dto/create-service.dto.js", "JavaScript", 64, 0, 0, 0, 0, 1, 0, 65
"/Users/imsunil/projects/unboxedkart/development/user/server/dist/service/dto/update-service.dto.d.ts", "TypeScript", 0, 0, 0, 0, 5, 0, 1, 6
"/Users/imsunil/projects/unboxedkart/development/user/server/dist/service/dto/update-service.dto.js", "JavaScript", 8, 0, 0, 0, 0, 1, 0, 9
"/Users/imsunil/projects/unboxedkart/development/user/server/dist/service/service.controller.d.ts", "TypeScript", 0, 0, 0, 0, 19, 3, 1, 23
"/Users/imsunil/projects/unboxedkart/development/user/server/dist/service/service.controller.js", "JavaScript", 90, 0, 0, 0, 0, 1, 0, 91
"/Users/imsunil/projects/unboxedkart/development/user/server/dist/service/service.module.d.ts", "TypeScript", 0, 0, 0, 0, 2, 0, 1, 3
"/Users/imsunil/projects/unboxedkart/development/user/server/dist/service/service.module.js", "JavaScript", 36, 0, 0, 0, 0, 1, 0, 37
"/Users/imsunil/projects/unboxedkart/development/user/server/dist/service/service.service.d.ts", "TypeScript", 0, 0, 0, 0, 26, 2, 1, 29
"/Users/imsunil/projects/unboxedkart/development/user/server/dist/service/service.service.js", "JavaScript", 98, 0, 0, 0, 0, 1, 0, 99
"/Users/imsunil/projects/unboxedkart/development/user/server/dist/services/dto/create-service.dto.d.ts", "TypeScript", 0, 0, 0, 0, 2, 0, 1, 3
"/Users/imsunil/projects/unboxedkart/development/user/server/dist/services/dto/create-service.dto.js", "JavaScript", 6, 0, 0, 0, 0, 1, 0, 7
"/Users/imsunil/projects/unboxedkart/development/user/server/dist/services/dto/update-service.dto.d.ts", "TypeScript", 0, 0, 0, 0, 5, 0, 1, 6
"/Users/imsunil/projects/unboxedkart/development/user/server/dist/services/dto/update-service.dto.js", "JavaScript", 8, 0, 0, 0, 0, 1, 0, 9
"/Users/imsunil/projects/unboxedkart/development/user/server/dist/services/services.controller.d.ts", "TypeScript", 0, 0, 0, 0, 15, 3, 1, 19
"/Users/imsunil/projects/unboxedkart/development/user/server/dist/services/services.controller.js", "JavaScript", 90, 0, 0, 0, 0, 1, 0, 91
"/Users/imsunil/projects/unboxedkart/development/user/server/dist/services/services.module.d.ts", "TypeScript", 0, 0, 0, 0, 2, 0, 1, 3
"/Users/imsunil/projects/unboxedkart/development/user/server/dist/services/services.module.js", "JavaScript", 26, 0, 0, 0, 0, 1, 0, 27
"/Users/imsunil/projects/unboxedkart/development/user/server/dist/services/services.service.d.ts", "TypeScript", 0, 0, 0, 0, 16, 2, 1, 19
"/Users/imsunil/projects/unboxedkart/development/user/server/dist/services/services.service.js", "JavaScript", 122, 0, 0, 0, 0, 1, 0, 123
"/Users/imsunil/projects/unboxedkart/development/user/server/dist/store-api/models/store-notification.model.d.ts", "TypeScript", 0, 0, 0, 0, 17, 0, 1, 18
"/Users/imsunil/projects/unboxedkart/development/user/server/dist/store-api/models/store-notification.model.js", "JavaScript", 19, 0, 0, 0, 0, 1, 0, 20
"/Users/imsunil/projects/unboxedkart/development/user/server/dist/store-api/orders/dto/cancel-order.dto.d.ts", "TypeScript", 0, 0, 0, 0, 6, 0, 1, 7
"/Users/imsunil/projects/unboxedkart/development/user/server/dist/store-api/orders/dto/cancel-order.dto.js", "JavaScript", 36, 0, 0, 0, 0, 1, 0, 37
"/Users/imsunil/projects/unboxedkart/development/user/server/dist/store-api/orders/dto/create-order.dto.d.ts", "TypeScript", 0, 0, 0, 0, 3, 0, 1, 4
"/Users/imsunil/projects/unboxedkart/development/user/server/dist/store-api/orders/dto/create-order.dto.js", "JavaScript", 21, 0, 0, 0, 0, 1, 0, 22
"/Users/imsunil/projects/unboxedkart/development/user/server/dist/store-api/orders/order.unused.service.d.ts", "TypeScript", 0, 0, 0, 0, 0, 0, 1, 1
"/Users/imsunil/projects/unboxedkart/development/user/server/dist/store-api/orders/order.unused.service.js", "JavaScript", 0, 0, 0, 0, 0, 1, 0, 1
"/Users/imsunil/projects/unboxedkart/development/user/server/dist/store-api/orders/orders.controller.d.ts", "TypeScript", 0, 0, 0, 0, 41, 3, 1, 45
"/Users/imsunil/projects/unboxedkart/development/user/server/dist/store-api/orders/orders.controller.js", "JavaScript", 141, 0, 0, 0, 0, 1, 0, 142
"/Users/imsunil/projects/unboxedkart/development/user/server/dist/store-api/orders/orders.module.d.ts", "TypeScript", 0, 0, 0, 0, 2, 0, 1, 3
"/Users/imsunil/projects/unboxedkart/development/user/server/dist/store-api/orders/orders.module.js", "JavaScript", 53, 0, 0, 0, 0, 1, 0, 54
"/Users/imsunil/projects/unboxedkart/development/user/server/dist/store-api/orders/orders.service.d.ts", "TypeScript", 0, 0, 0, 0, 116, 2, 1, 119
"/Users/imsunil/projects/unboxedkart/development/user/server/dist/store-api/orders/orders.service.js", "JavaScript", 521, 0, 0, 0, 0, 1, 0, 522
"/Users/imsunil/projects/unboxedkart/development/user/server/dist/store-api/token/dto/cancel-order.dto.d.ts", "TypeScript", 0, 0, 0, 0, 6, 0, 1, 7
"/Users/imsunil/projects/unboxedkart/development/user/server/dist/store-api/token/dto/cancel-order.dto.js", "JavaScript", 36, 0, 0, 0, 0, 1, 0, 37
"/Users/imsunil/projects/unboxedkart/development/user/server/dist/store-api/token/dto/create-order.dto.d.ts", "TypeScript", 0, 0, 0, 0, 3, 0, 1, 4
"/Users/imsunil/projects/unboxedkart/development/user/server/dist/store-api/token/dto/create-order.dto.js", "JavaScript", 21, 0, 0, 0, 0, 1, 0, 22
"/Users/imsunil/projects/unboxedkart/development/user/server/dist/store-api/token/dto/create-token.dto.d.ts", "TypeScript", 0, 0, 0, 0, 17, 0, 1, 18
"/Users/imsunil/projects/unboxedkart/development/user/server/dist/store-api/token/dto/create-token.dto.js", "JavaScript", 91, 0, 0, 0, 0, 1, 0, 92
"/Users/imsunil/projects/unboxedkart/development/user/server/dist/store-api/token/order.unused.service.d.ts", "TypeScript", 0, 0, 0, 0, 0, 0, 1, 1
"/Users/imsunil/projects/unboxedkart/development/user/server/dist/store-api/token/order.unused.service.js", "JavaScript", 0, 0, 0, 0, 0, 1, 0, 1
"/Users/imsunil/projects/unboxedkart/development/user/server/dist/store-api/token/orders.controller.d.ts", "TypeScript", 0, 0, 0, 0, 12, 0, 1, 13
"/Users/imsunil/projects/unboxedkart/development/user/server/dist/store-api/token/orders.controller.js", "JavaScript", 81, 0, 0, 0, 0, 1, 0, 82
"/Users/imsunil/projects/unboxedkart/development/user/server/dist/store-api/token/orders.module.d.ts", "TypeScript", 0, 0, 0, 0, 2, 0, 1, 3
"/Users/imsunil/projects/unboxedkart/development/user/server/dist/store-api/token/orders.module.js", "JavaScript", 32, 0, 0, 0, 0, 1, 0, 33
"/Users/imsunil/projects/unboxedkart/development/user/server/dist/store-api/token/orders.service.d.ts", "TypeScript", 0, 0, 0, 0, 116, 2, 1, 119
"/Users/imsunil/projects/unboxedkart/development/user/server/dist/store-api/token/orders.service.js", "JavaScript", 521, 0, 0, 0, 0, 1, 0, 522
"/Users/imsunil/projects/unboxedkart/development/user/server/dist/store-api/token/store-token.controller.d.ts", "TypeScript", 0, 0, 0, 0, 12, 0, 1, 13
"/Users/imsunil/projects/unboxedkart/development/user/server/dist/store-api/token/store-token.controller.js", "JavaScript", 61, 0, 0, 0, 0, 1, 0, 62
"/Users/imsunil/projects/unboxedkart/development/user/server/dist/store-api/token/store-token.module.d.ts", "TypeScript", 0, 0, 0, 0, 2, 0, 1, 3
"/Users/imsunil/projects/unboxedkart/development/user/server/dist/store-api/token/store-token.module.js", "JavaScript", 32, 0, 0, 0, 0, 1, 0, 33
"/Users/imsunil/projects/unboxedkart/development/user/server/dist/store-api/token/store-token.service.d.ts", "TypeScript", 0, 0, 0, 0, 12, 0, 1, 13
"/Users/imsunil/projects/unboxedkart/development/user/server/dist/store-api/token/store-token.service.js", "JavaScript", 47, 0, 0, 0, 0, 1, 0, 48
"/Users/imsunil/projects/unboxedkart/development/user/server/dist/store-location/store-location.controller.d.ts", "TypeScript", 0, 0, 0, 0, 8, 3, 1, 12
"/Users/imsunil/projects/unboxedkart/development/user/server/dist/store-location/store-location.controller.js", "JavaScript", 34, 0, 0, 0, 0, 1, 0, 35
"/Users/imsunil/projects/unboxedkart/development/user/server/dist/store-location/store-location.module.d.ts", "TypeScript", 0, 0, 0, 0, 2, 0, 1, 3
"/Users/imsunil/projects/unboxedkart/development/user/server/dist/store-location/store-location.module.js", "JavaScript", 29, 0, 0, 0, 0, 1, 0, 30
"/Users/imsunil/projects/unboxedkart/development/user/server/dist/store-location/store-location.service.d.ts", "TypeScript", 0, 0, 0, 0, 9, 2, 1, 12
"/Users/imsunil/projects/unboxedkart/development/user/server/dist/store-location/store-location.service.js", "JavaScript", 33, 0, 0, 0, 0, 1, 0, 34
"/Users/imsunil/projects/unboxedkart/development/user/server/dist/usage-tracking/coupons.controller.d.ts", "TypeScript", 0, 0, 0, 0, 26, 3, 1, 30
"/Users/imsunil/projects/unboxedkart/development/user/server/dist/usage-tracking/coupons.controller.js", "JavaScript", 70, 0, 0, 0, 0, 1, 0, 71
"/Users/imsunil/projects/unboxedkart/development/user/server/dist/usage-tracking/coupons.module.d.ts", "TypeScript", 0, 0, 0, 0, 2, 0, 1, 3
"/Users/imsunil/projects/unboxedkart/development/user/server/dist/usage-tracking/coupons.module.js", "JavaScript", 36, 0, 0, 0, 0, 1, 0, 37
"/Users/imsunil/projects/unboxedkart/development/user/server/dist/usage-tracking/coupons.service.d.ts", "TypeScript", 0, 0, 0, 0, 40, 2, 1, 43
"/Users/imsunil/projects/unboxedkart/development/user/server/dist/usage-tracking/coupons.service.js", "JavaScript", 155, 0, 0, 0, 0, 1, 0, 156
"/Users/imsunil/projects/unboxedkart/development/user/server/dist/usage-tracking/dtos/add-cart-item.dto.d.ts", "TypeScript", 0, 0, 0, 0, 3, 0, 1, 4
"/Users/imsunil/projects/unboxedkart/development/user/server/dist/usage-tracking/dtos/add-cart-item.dto.js", "JavaScript", 21, 0, 0, 0, 0, 1, 0, 22
"/Users/imsunil/projects/unboxedkart/development/user/server/dist/usage-tracking/dtos/add-searched-term.dto.d.ts", "TypeScript", 0, 0, 0, 0, 3, 0, 1, 4
"/Users/imsunil/projects/unboxedkart/development/user/server/dist/usage-tracking/dtos/add-searched-term.dto.js", "JavaScript", 21, 0, 0, 0, 0, 1, 0, 22
"/Users/imsunil/projects/unboxedkart/development/user/server/dist/usage-tracking/dtos/add-viewed-product.dto.d.ts", "TypeScript", 0, 0, 0, 0, 3, 0, 1, 4
"/Users/imsunil/projects/unboxedkart/development/user/server/dist/usage-tracking/dtos/add-viewed-product.dto.js", "JavaScript", 21, 0, 0, 0, 0, 1, 0, 22
"/Users/imsunil/projects/unboxedkart/development/user/server/dist/usage-tracking/dtos/add-wishlist-item.dto.d.ts", "TypeScript", 0, 0, 0, 0, 3, 0, 1, 4
"/Users/imsunil/projects/unboxedkart/development/user/server/dist/usage-tracking/dtos/add-wishlist-item.dto.js", "JavaScript", 21, 0, 0, 0, 0, 1, 0, 22
"/Users/imsunil/projects/unboxedkart/development/user/server/dist/usage-tracking/dtos/clicked-on-buy-now.dto.d.ts", "TypeScript", 0, 0, 0, 0, 3, 0, 1, 4
"/Users/imsunil/projects/unboxedkart/development/user/server/dist/usage-tracking/dtos/clicked-on-buy-now.dto.js", "JavaScript", 21, 0, 0, 0, 0, 1, 0, 22
"/Users/imsunil/projects/unboxedkart/development/user/server/dist/usage-tracking/dtos/clicked-on-need-more-discount.dto.d.ts", "TypeScript", 0, 0, 0, 0, 3, 0, 1, 4
"/Users/imsunil/projects/unboxedkart/development/user/server/dist/usage-tracking/dtos/clicked-on-need-more-discount.dto.js", "JavaScript", 21, 0, 0, 0, 0, 1, 0, 22
"/Users/imsunil/projects/unboxedkart/development/user/server/dist/usage-tracking/dtos/remove-cart-item.dto.d.ts", "TypeScript", 0, 0, 0, 0, 3, 0, 1, 4
"/Users/imsunil/projects/unboxedkart/development/user/server/dist/usage-tracking/dtos/remove-cart-item.dto.js", "JavaScript", 21, 0, 0, 0, 0, 1, 0, 22
"/Users/imsunil/projects/unboxedkart/development/user/server/dist/usage-tracking/dtos/remove-wishlist-item.dto.d.ts", "TypeScript", 0, 0, 0, 0, 3, 0, 1, 4
"/Users/imsunil/projects/unboxedkart/development/user/server/dist/usage-tracking/dtos/remove-wishlist-item.dto.js", "JavaScript", 21, 0, 0, 0, 0, 1, 0, 22
"/Users/imsunil/projects/unboxedkart/development/user/server/dist/usage-tracking/usage-tracking.controller.d.ts", "TypeScript", 0, 0, 0, 0, 25, 0, 1, 26
"/Users/imsunil/projects/unboxedkart/development/user/server/dist/usage-tracking/usage-tracking.controller.js", "JavaScript", 161, 0, 0, 0, 0, 1, 0, 162
"/Users/imsunil/projects/unboxedkart/development/user/server/dist/usage-tracking/usage-tracking.module.d.ts", "TypeScript", 0, 0, 0, 0, 2, 0, 1, 3
"/Users/imsunil/projects/unboxedkart/development/user/server/dist/usage-tracking/usage-tracking.module.js", "JavaScript", 36, 0, 0, 0, 0, 1, 0, 37
"/Users/imsunil/projects/unboxedkart/development/user/server/dist/usage-tracking/usage-tracking.service.d.ts", "TypeScript", 0, 0, 0, 0, 27, 0, 1, 28
"/Users/imsunil/projects/unboxedkart/development/user/server/dist/usage-tracking/usage-tracking.service.js", "JavaScript", 144, 0, 0, 0, 0, 1, 0, 145
"/Users/imsunil/projects/unboxedkart/development/user/server/dist/user/dto/update-user-details.dto.d.ts", "TypeScript", 0, 0, 0, 0, 4, 0, 1, 5
"/Users/imsunil/projects/unboxedkart/development/user/server/dist/user/dto/update-user-details.dto.js", "JavaScript", 26, 0, 0, 0, 0, 1, 0, 27
"/Users/imsunil/projects/unboxedkart/development/user/server/dist/user/dto/update-user-payment-details.dto.d.ts", "TypeScript", 0, 0, 0, 0, 4, 0, 1, 5
"/Users/imsunil/projects/unboxedkart/development/user/server/dist/user/dto/update-user-payment-details.dto.js", "JavaScript", 26, 0, 0, 0, 0, 1, 0, 27
"/Users/imsunil/projects/unboxedkart/development/user/server/dist/user/user.controller.d.ts", "TypeScript", 0, 0, 0, 0, 19, 3, 1, 23
"/Users/imsunil/projects/unboxedkart/development/user/server/dist/user/user.controller.js", "JavaScript", 95, 0, 0, 0, 0, 1, 0, 96
"/Users/imsunil/projects/unboxedkart/development/user/server/dist/user/user.module.d.ts", "TypeScript", 0, 0, 0, 0, 2, 0, 1, 3
"/Users/imsunil/projects/unboxedkart/development/user/server/dist/user/user.module.js", "JavaScript", 31, 0, 0, 0, 0, 1, 0, 32
"/Users/imsunil/projects/unboxedkart/development/user/server/dist/user/user.service.d.ts", "TypeScript", 0, 0, 0, 0, 22, 2, 1, 25
"/Users/imsunil/projects/unboxedkart/development/user/server/dist/user/user.service.js", "JavaScript", 84, 0, 0, 0, 0, 1, 0, 85
"/Users/imsunil/projects/unboxedkart/development/user/server/dist/variants/variants.controller.d.ts", "TypeScript", 0, 0, 0, 0, 7, 0, 1, 8
"/Users/imsunil/projects/unboxedkart/development/user/server/dist/variants/variants.controller.js", "JavaScript", 48, 0, 0, 0, 0, 1, 0, 49
"/Users/imsunil/projects/unboxedkart/development/user/server/dist/variants/variants.module.d.ts", "TypeScript", 0, 0, 0, 0, 2, 0, 1, 3
"/Users/imsunil/projects/unboxedkart/development/user/server/dist/variants/variants.module.js", "JavaScript", 28, 0, 0, 0, 0, 1, 0, 29
"/Users/imsunil/projects/unboxedkart/development/user/server/dist/variants/variants.service.d.ts", "TypeScript", 0, 0, 0, 0, 8, 0, 1, 9
"/Users/imsunil/projects/unboxedkart/development/user/server/dist/variants/variants.service.js", "JavaScript", 52, 0, 0, 0, 0, 1, 0, 53
"/Users/imsunil/projects/unboxedkart/development/user/server/nest-cli.json", "JSON", 0, 4, 0, 0, 0, 0, 1, 5
"/Users/imsunil/projects/unboxedkart/development/user/server/package-lock.json", "JSON", 0, 20194, 0, 0, 0, 0, 1, 20195
"/Users/imsunil/projects/unboxedkart/development/user/server/package.json", "JSON", 0, 94, 0, 0, 0, 9, 0, 103
"/Users/imsunil/projects/unboxedkart/development/user/server/src/addresses/addresses.controller.ts", "TypeScript", 0, 0, 0, 0, 57, 0, 6, 63
"/Users/imsunil/projects/unboxedkart/development/user/server/src/addresses/addresses.module.ts", "TypeScript", 0, 0, 0, 0, 15, 0, 2, 17
"/Users/imsunil/projects/unboxedkart/development/user/server/src/addresses/addresses.service.ts", "TypeScript", 0, 0, 0, 0, 42, 0, 6, 48
"/Users/imsunil/projects/unboxedkart/development/user/server/src/addresses/dto/add-address.dto.ts", "TypeScript", 0, 0, 0, 0, 37, 0, 12, 49
"/Users/imsunil/projects/unboxedkart/development/user/server/src/addresses/dto/address.dto.ts", "TypeScript", 0, 0, 0, 0, 34, 0, 11, 45
"/Users/imsunil/projects/unboxedkart/development/user/server/src/addresses/dto/index.ts", "TypeScript", 0, 0, 0, 0, 3, 0, 0, 3
"/Users/imsunil/projects/unboxedkart/development/user/server/src/addresses/dto/update-address.dto.ts", "TypeScript", 0, 0, 0, 0, 41, 0, 13, 54
"/Users/imsunil/projects/unboxedkart/development/user/server/src/app-version/app-version.controller.spec.ts", "TypeScript", 0, 0, 0, 0, 16, 0, 5, 21
"/Users/imsunil/projects/unboxedkart/development/user/server/src/app-version/app-version.controller.ts", "TypeScript", 0, 0, 0, 0, 15, 0, 4, 19
"/Users/imsunil/projects/unboxedkart/development/user/server/src/app-version/app-version.module.ts", "TypeScript", 0, 0, 0, 0, 15, 0, 2, 17
"/Users/imsunil/projects/unboxedkart/development/user/server/src/app-version/app-version.service.spec.ts", "TypeScript", 0, 0, 0, 0, 14, 0, 5, 19
"/Users/imsunil/projects/unboxedkart/development/user/server/src/app-version/app-version.service.ts", "TypeScript", 0, 0, 0, 0, 27, 0, 4, 31
"/Users/imsunil/projects/unboxedkart/development/user/server/src/app-version/dto/create-app-version.dto.ts", "TypeScript", 0, 0, 0, 0, 15, 0, 5, 20
"/Users/imsunil/projects/unboxedkart/development/user/server/src/app-version/entities/app-version.entity.ts", "TypeScript", 0, 0, 0, 0, 1, 0, 1, 2
"/Users/imsunil/projects/unboxedkart/development/user/server/src/app.controller.ts", "TypeScript", 0, 0, 0, 0, 10, 2, 2, 14
"/Users/imsunil/projects/unboxedkart/development/user/server/src/app.module.ts", "TypeScript", 0, 0, 0, 0, 69, 7, 3, 79
"/Users/imsunil/projects/unboxedkart/development/user/server/src/app.service.ts", "TypeScript", 0, 0, 0, 0, 7, 0, 2, 9
"/Users/imsunil/projects/unboxedkart/development/user/server/src/auth/auth.controller.ts", "TypeScript", 0, 0, 0, 0, 83, 6, 12, 101
"/Users/imsunil/projects/unboxedkart/development/user/server/src/auth/auth.module.ts", "TypeScript", 0, 0, 0, 0, 39, 1, 2, 42
"/Users/imsunil/projects/unboxedkart/development/user/server/src/auth/auth.service.ts", "TypeScript", 0, 0, 0, 0, 364, 94, 31, 489
"/Users/imsunil/projects/unboxedkart/development/user/server/src/auth/dto/login.dto.ts", "TypeScript", 0, 0, 0, 0, 12, 0, 4, 16
"/Users/imsunil/projects/unboxedkart/development/user/server/src/auth/dto/sign-up.dto.ts", "TypeScript", 0, 0, 0, 0, 21, 0, 7, 28
"/Users/imsunil/projects/unboxedkart/development/user/server/src/auth/jwt-strategies/jwt-auth.guard.ts", "TypeScript", 0, 0, 0, 0, 4, 0, 1, 5
"/Users/imsunil/projects/unboxedkart/development/user/server/src/auth/jwt-strategies/jwt-refresh-auth.guard.ts", "TypeScript", 0, 0, 0, 0, 4, 0, 1, 5
"/Users/imsunil/projects/unboxedkart/development/user/server/src/auth/jwt-strategies/jwt-refresh.strategy.ts", "TypeScript", 0, 0, 0, 0, 19, 1, 3, 23
"/Users/imsunil/projects/unboxedkart/development/user/server/src/auth/jwt-strategies/jwt.strategy.ts", "TypeScript", 0, 0, 0, 0, 19, 1, 3, 23
"/Users/imsunil/projects/unboxedkart/development/user/server/src/carousel-items/carousel-items.controller.spec.ts", "TypeScript", 0, 0, 0, 0, 16, 0, 5, 21
"/Users/imsunil/projects/unboxedkart/development/user/server/src/carousel-items/carousel-items.controller.ts", "TypeScript", 0, 0, 0, 0, 50, 11, 12, 73
"/Users/imsunil/projects/unboxedkart/development/user/server/src/carousel-items/carousel-items.module.ts", "TypeScript", 0, 0, 0, 0, 15, 0, 2, 17
"/Users/imsunil/projects/unboxedkart/development/user/server/src/carousel-items/carousel-items.service.spec.ts", "TypeScript", 0, 0, 0, 0, 14, 0, 5, 19
"/Users/imsunil/projects/unboxedkart/development/user/server/src/carousel-items/carousel-items.service.ts", "TypeScript", 0, 0, 0, 0, 153, 674, 23, 850
"/Users/imsunil/projects/unboxedkart/development/user/server/src/carousel-items/dto/create-carousel-item.dto.ts", "TypeScript", 0, 0, 0, 0, 49, 0, 14, 63
"/Users/imsunil/projects/unboxedkart/development/user/server/src/carousel-items/dto/update-carousel-item.dto.ts", "TypeScript", 0, 0, 0, 0, 3, 0, 2, 5
"/Users/imsunil/projects/unboxedkart/development/user/server/src/carousel-items/entities/carousel-item.entity.ts", "TypeScript", 0, 0, 0, 0, 0, 1, 1, 2
"/Users/imsunil/projects/unboxedkart/development/user/server/src/cart/cart.controller.ts", "TypeScript", 0, 0, 0, 0, 91, 2, 9, 102
"/Users/imsunil/projects/unboxedkart/development/user/server/src/cart/cart.module.ts", "TypeScript", 0, 0, 0, 0, 22, 0, 2, 24
"/Users/imsunil/projects/unboxedkart/development/user/server/src/cart/cart.service.ts", "TypeScript", 0, 0, 0, 0, 176, 90, 18, 284
"/Users/imsunil/projects/unboxedkart/development/user/server/src/cart/dto/add-cart-item.dto.ts", "TypeScript", 0, 0, 0, 0, 9, 0, 3, 12
"/Users/imsunil/projects/unboxedkart/development/user/server/src/cart/dto/update-cart-item.dto.ts", "TypeScript", 0, 0, 0, 0, 10, 0, 3, 13
"/Users/imsunil/projects/unboxedkart/development/user/server/src/coupons/coupons.controller.ts", "TypeScript", 0, 0, 0, 0, 50, 1, 7, 58
"/Users/imsunil/projects/unboxedkart/development/user/server/src/coupons/coupons.module.ts", "TypeScript", 0, 0, 0, 0, 23, 0, 2, 25
"/Users/imsunil/projects/unboxedkart/development/user/server/src/coupons/coupons.service.ts", "TypeScript", 0, 0, 0, 0, 137, 75, 14, 226
"/Users/imsunil/projects/unboxedkart/development/user/server/src/exceptions/http-exception.filter.ts", "TypeScript", 0, 0, 0, 0, 21, 2, 2, 25
"/Users/imsunil/projects/unboxedkart/development/user/server/src/faqs/dto/create-faq.dto.ts", "TypeScript", 0, 0, 0, 0, 9, 2, 4, 15
"/Users/imsunil/projects/unboxedkart/development/user/server/src/faqs/faqs.controller.ts", "TypeScript", 0, 0, 0, 0, 37, 6, 4, 47
"/Users/imsunil/projects/unboxedkart/development/user/server/src/faqs/faqs.module.ts", "TypeScript", 0, 0, 0, 0, 20, 0, 2, 22
"/Users/imsunil/projects/unboxedkart/development/user/server/src/faqs/faqs.service.ts", "TypeScript", 0, 0, 0, 0, 29, 4, 8, 41
"/Users/imsunil/projects/unboxedkart/development/user/server/src/favorites/favorites.controller.ts", "TypeScript", 0, 0, 0, 0, 45, 1, 5, 51
"/Users/imsunil/projects/unboxedkart/development/user/server/src/favorites/favorites.module.ts", "TypeScript", 0, 0, 0, 0, 20, 0, 2, 22
"/Users/imsunil/projects/unboxedkart/development/user/server/src/favorites/favorites.service.ts", "TypeScript", 0, 0, 0, 0, 87, 3, 6, 96
"/Users/imsunil/projects/unboxedkart/development/user/server/src/local-inventory/dto/add-product.dto.ts", "TypeScript", 0, 0, 0, 0, 35, 78, 39, 152
"/Users/imsunil/projects/unboxedkart/development/user/server/src/local-inventory/dto/add-seller.dto.ts", "TypeScript", 0, 0, 0, 0, 15, 5, 7, 27
"/Users/imsunil/projects/unboxedkart/development/user/server/src/local-inventory/dto/sell-product.dto.ts", "TypeScript", 0, 0, 0, 0, 21, 4, 8, 33
"/Users/imsunil/projects/unboxedkart/development/user/server/src/local-inventory/local-inventory.controller.ts", "TypeScript", 0, 0, 0, 0, 156, 6, 18, 180
"/Users/imsunil/projects/unboxedkart/development/user/server/src/local-inventory/local-inventory.module.ts", "TypeScript", 0, 0, 0, 0, 33, 0, 2, 35
"/Users/imsunil/projects/unboxedkart/development/user/server/src/local-inventory/local-inventory.service.ts", "TypeScript", 0, 0, 0, 0, 219, 20, 16, 255
"/Users/imsunil/projects/unboxedkart/development/user/server/src/mail/mail.module.ts", "TypeScript", 0, 0, 0, 0, 24, 0, 2, 26
"/Users/imsunil/projects/unboxedkart/development/user/server/src/mail/mail.service.spec.ts", "TypeScript", 0, 0, 0, 0, 14, 0, 5, 19
"/Users/imsunil/projects/unboxedkart/development/user/server/src/mail/mail.service.ts", "TypeScript", 0, 0, 0, 0, 3, 0, 2, 5
"/Users/imsunil/projects/unboxedkart/development/user/server/src/main.ts", "TypeScript", 0, 0, 0, 0, 19, 4, 2, 25
"/Users/imsunil/projects/unboxedkart/development/user/server/src/models/address.model.ts", "TypeScript", 0, 0, 0, 0, 28, 0, 3, 31
"/Users/imsunil/projects/unboxedkart/development/user/server/src/models/admin/admin.model.ts", "TypeScript", 0, 0, 0, 0, 17, 0, 3, 20
"/Users/imsunil/projects/unboxedkart/development/user/server/src/models/admin/notification.model.ts", "TypeScript", 0, 0, 0, 0, 16, 2, 6, 24
"/Users/imsunil/projects/unboxedkart/development/user/server/src/models/admin/seller.model.ts", "TypeScript", 0, 0, 0, 0, 25, 0, 3, 28
"/Users/imsunil/projects/unboxedkart/development/user/server/src/models/answer.model.ts", "TypeScript", 0, 0, 0, 0, 35, 0, 4, 39
"/Users/imsunil/projects/unboxedkart/development/user/server/src/models/app_version.model.ts", "TypeScript", 0, 0, 0, 0, 15, 0, 3, 18
"/Users/imsunil/projects/unboxedkart/development/user/server/src/models/carousel_item.model.ts", "TypeScript", 0, 0, 0, 0, 42, 0, 4, 46
"/Users/imsunil/projects/unboxedkart/development/user/server/src/models/cart-item.model.ts", "TypeScript", 0, 0, 0, 0, 13, 0, 3, 16
"/Users/imsunil/projects/unboxedkart/development/user/server/src/models/coupon.model.ts", "TypeScript", 0, 0, 0, 0, 59, 1, 7, 67
"/Users/imsunil/projects/unboxedkart/development/user/server/src/models/faq.model.ts", "TypeScript", 0, 0, 0, 0, 11, 0, 3, 14
"/Users/imsunil/projects/unboxedkart/development/user/server/src/models/favorite.model.ts", "TypeScript", 0, 0, 0, 0, 11, 0, 3, 14
"/Users/imsunil/projects/unboxedkart/development/user/server/src/models/item-purchased-user.model.ts", "TypeScript", 0, 0, 0, 0, 27, 0, 3, 30
"/Users/imsunil/projects/unboxedkart/development/user/server/src/models/local_inventory/agent.model.ts", "TypeScript", 0, 0, 0, 0, 17, 0, 2, 19
"/Users/imsunil/projects/unboxedkart/development/user/server/src/models/local_inventory/buyer.model.ts", "TypeScript", 0, 0, 0, 0, 17, 0, 3, 20
"/Users/imsunil/projects/unboxedkart/development/user/server/src/models/local_inventory/customer.model.ts", "TypeScript", 0, 0, 0, 0, 25, 0, 3, 28
"/Users/imsunil/projects/unboxedkart/development/user/server/src/models/local_inventory/notification.model.ts", "TypeScript", 0, 0, 0, 0, 13, 2, 3, 18
"/Users/imsunil/projects/unboxedkart/development/user/server/src/models/local_inventory/product.model.ts", "TypeScript", 0, 0, 0, 0, 110, 0, 5, 115
"/Users/imsunil/projects/unboxedkart/development/user/server/src/models/local_inventory/purchased-item.model.ts", "TypeScript", 0, 0, 0, 0, 23, 0, 3, 26
"/Users/imsunil/projects/unboxedkart/development/user/server/src/models/local_inventory/vendor.model.ts", "TypeScript", 0, 0, 0, 0, 19, 0, 3, 22
"/Users/imsunil/projects/unboxedkart/development/user/server/src/models/notification.model.ts", "TypeScript", 0, 0, 0, 0, 20, 0, 3, 23
"/Users/imsunil/projects/unboxedkart/development/user/server/src/models/order.model.ts", "TypeScript", 0, 0, 0, 0, 123, 20, 13, 156
"/Users/imsunil/projects/unboxedkart/development/user/server/src/models/orderItem.model.ts", "TypeScript", 0, 0, 0, 0, 122, 2, 3, 127
"/Users/imsunil/projects/unboxedkart/development/user/server/src/models/order_summary.model.ts", "TypeScript", 0, 0, 0, 0, 79, 8, 24, 111
"/Users/imsunil/projects/unboxedkart/development/user/server/src/models/ordered_service.model.ts", "TypeScript", 0, 0, 0, 0, 11, 0, 3, 14
"/Users/imsunil/projects/unboxedkart/development/user/server/src/models/payment.model.ts", "TypeScript", 0, 0, 0, 0, 27, 0, 3, 30
"/Users/imsunil/projects/unboxedkart/development/user/server/src/models/product-description.ts", "TypeScript", 0, 0, 0, 0, 9, 0, 5, 14
"/Users/imsunil/projects/unboxedkart/development/user/server/src/models/product-specs.ts", "TypeScript", 0, 0, 0, 0, 19, 0, 3, 22
"/Users/imsunil/projects/unboxedkart/development/user/server/src/models/product.model.ts", "TypeScript", 0, 0, 0, 0, 119, 0, 3, 122
"/Users/imsunil/projects/unboxedkart/development/user/server/src/models/product_data.model.ts", "TypeScript", 0, 0, 0, 0, 109, 0, 4, 113
"/Users/imsunil/projects/unboxedkart/development/user/server/src/models/product_images.model.ts", "TypeScript", 0, 0, 0, 0, 17, 0, 3, 20
"/Users/imsunil/projects/unboxedkart/development/user/server/src/models/q_and_a.model.ts", "TypeScript", 0, 0, 0, 0, 51, 1, 3, 55
"/Users/imsunil/projects/unboxedkart/development/user/server/src/models/question.model.ts", "TypeScript", 0, 0, 0, 0, 38, 0, 3, 41
"/Users/imsunil/projects/unboxedkart/development/user/server/src/models/referral_order.ts", "TypeScript", 0, 0, 0, 0, 47, 0, 3, 50
"/Users/imsunil/projects/unboxedkart/development/user/server/src/models/refresh-token.model.ts", "TypeScript", 0, 0, 0, 0, 11, 0, 3, 14
"/Users/imsunil/projects/unboxedkart/development/user/server/src/models/review.model.ts", "TypeScript", 0, 0, 0, 0, 27, 0, 3, 30
"/Users/imsunil/projects/unboxedkart/development/user/server/src/models/reviews_data.model.ts", "TypeScript", 0, 0, 0, 0, 23, 0, 3, 26
"/Users/imsunil/projects/unboxedkart/development/user/server/src/models/save_to_later.model.ts", "TypeScript", 0, 0, 0, 0, 13, 0, 3, 16
"/Users/imsunil/projects/unboxedkart/development/user/server/src/models/search_term.ts", "TypeScript", 0, 0, 0, 0, 13, 0, 3, 16
"/Users/imsunil/projects/unboxedkart/development/user/server/src/models/service.model.ts", "TypeScript", 0, 0, 0, 0, 15, 0, 3, 18
"/Users/imsunil/projects/unboxedkart/development/user/server/src/models/service_order.model.ts", "TypeScript", 0, 0, 0, 0, 36, 0, 3, 39
"/Users/imsunil/projects/unboxedkart/development/user/server/src/models/store-app/token.model.ts", "TypeScript", 0, 0, 0, 0, 46, 0, 3, 49
"/Users/imsunil/projects/unboxedkart/development/user/server/src/models/store_location.model.ts", "TypeScript", 0, 0, 0, 0, 23, 0, 3, 26
"/Users/imsunil/projects/unboxedkart/development/user/server/src/models/tracking-notification.model.ts", "TypeScript", 0, 0, 0, 0, 22, 0, 3, 25
"/Users/imsunil/projects/unboxedkart/development/user/server/src/models/user.model.ts", "TypeScript", 0, 0, 0, 0, 73, 23, 6, 102
"/Users/imsunil/projects/unboxedkart/development/user/server/src/models/user_payment_details.model.ts", "TypeScript", 0, 0, 0, 0, 11, 0, 3, 14
"/Users/imsunil/projects/unboxedkart/development/user/server/src/models/variants_data.model.ts", "TypeScript", 0, 0, 0, 0, 17, 0, 3, 20
"/Users/imsunil/projects/unboxedkart/development/user/server/src/order-summary/dto/add-address.dto.ts", "TypeScript", 0, 0, 0, 0, 37, 14, 19, 70
"/Users/imsunil/projects/unboxedkart/development/user/server/src/order-summary/dto/add-selected-store.dto.ts", "TypeScript", 0, 0, 0, 0, 50, 3, 15, 68
"/Users/imsunil/projects/unboxedkart/development/user/server/src/order-summary/dto/create-order-summary.dto.ts", "TypeScript", 0, 0, 0, 0, 9, 0, 3, 12
"/Users/imsunil/projects/unboxedkart/development/user/server/src/order-summary/dto/update-count.dto.ts", "TypeScript", 0, 0, 0, 0, 12, 0, 4, 16
"/Users/imsunil/projects/unboxedkart/development/user/server/src/order-summary/dto/verify-payment.dto.ts", "TypeScript", 0, 0, 0, 0, 12, 0, 4, 16
"/Users/imsunil/projects/unboxedkart/development/user/server/src/order-summary/order-summary.controller.ts", "TypeScript", 0, 0, 0, 0, 142, 9, 13, 164
"/Users/imsunil/projects/unboxedkart/development/user/server/src/order-summary/order-summary.module.ts", "TypeScript", 0, 0, 0, 0, 29, 0, 2, 31
"/Users/imsunil/projects/unboxedkart/development/user/server/src/order-summary/order-summary.service.ts", "TypeScript", 0, 0, 0, 0, 408, 46, 38, 492
"/Users/imsunil/projects/unboxedkart/development/user/server/src/orders/dto/cancel-order.dto.ts", "TypeScript", 0, 0, 0, 0, 15, 0, 5, 20
"/Users/imsunil/projects/unboxedkart/development/user/server/src/orders/dto/create-order.dto.ts", "TypeScript", 0, 0, 0, 0, 6, 13, 6, 25
"/Users/imsunil/projects/unboxedkart/development/user/server/src/orders/order.unused.service.ts", "TypeScript", 0, 0, 0, 0, 0, 320, 25, 345
"/Users/imsunil/projects/unboxedkart/development/user/server/src/orders/orders.controller.ts", "TypeScript", 0, 0, 0, 0, 88, 1, 12, 101
"/Users/imsunil/projects/unboxedkart/development/user/server/src/orders/orders.module.ts", "TypeScript", 0, 0, 0, 0, 41, 0, 2, 43
"/Users/imsunil/projects/unboxedkart/development/user/server/src/orders/orders.service.ts", "TypeScript", 0, 0, 0, 0, 563, 105, 52, 720
"/Users/imsunil/projects/unboxedkart/development/user/server/src/product-details/product-details.controller.ts", "TypeScript", 0, 0, 0, 0, 42, 0, 10, 52
"/Users/imsunil/projects/unboxedkart/development/user/server/src/product-details/product-details.module.ts", "TypeScript", 0, 0, 0, 0, 23, 0, 2, 25
"/Users/imsunil/projects/unboxedkart/development/user/server/src/product-details/product-details.service.ts", "TypeScript", 0, 0, 0, 0, 72, 4, 14, 90
"/Users/imsunil/projects/unboxedkart/development/user/server/src/products/product.module.ts", "TypeScript", 0, 0, 0, 0, 28, 0, 2, 30
"/Users/imsunil/projects/unboxedkart/development/user/server/src/products/products.controller.ts", "TypeScript", 0, 0, 0, 0, 97, 19, 15, 131
"/Users/imsunil/projects/unboxedkart/development/user/server/src/products/products.service.ts", "TypeScript", 0, 0, 0, 0, 370, 81, 23, 474
"/Users/imsunil/projects/unboxedkart/development/user/server/src/q-and-a/dto/create_answer.dto.ts", "TypeScript", 0, 0, 0, 0, 18, 0, 6, 24
"/Users/imsunil/projects/unboxedkart/development/user/server/src/q-and-a/dto/create_question.dto.ts", "TypeScript", 0, 0, 0, 0, 9, 3, 4, 16
"/Users/imsunil/projects/unboxedkart/development/user/server/src/q-and-a/q-and-a.controller.ts", "TypeScript", 0, 0, 0, 0, 95, 0, 16, 111
"/Users/imsunil/projects/unboxedkart/development/user/server/src/q-and-a/q-and-a.module.ts", "TypeScript", 0, 0, 0, 0, 28, 0, 2, 30
"/Users/imsunil/projects/unboxedkart/development/user/server/src/q-and-a/q-and-a.service.ts", "TypeScript", 0, 0, 0, 0, 155, 19, 15, 189
"/Users/imsunil/projects/unboxedkart/development/user/server/src/reviews/dto/create-review.dto.ts", "TypeScript", 0, 0, 0, 0, 17, 0, 6, 23
"/Users/imsunil/projects/unboxedkart/development/user/server/src/reviews/dto/update-review.dto.ts", "TypeScript", 0, 0, 0, 0, 33, 0, 9, 42
"/Users/imsunil/projects/unboxedkart/development/user/server/src/reviews/reviews.controller.ts", "TypeScript", 0, 0, 0, 0, 73, 7, 9, 89
"/Users/imsunil/projects/unboxedkart/development/user/server/src/reviews/reviews.module.ts", "TypeScript", 0, 0, 0, 0, 23, 0, 2, 25
"/Users/imsunil/projects/unboxedkart/development/user/server/src/reviews/reviews.service.ts", "TypeScript", 0, 0, 0, 0, 91, 13, 13, 117
"/Users/imsunil/projects/unboxedkart/development/user/server/src/s3/s3.controller.spec.ts", "TypeScript", 0, 0, 0, 0, 16, 0, 5, 21
"/Users/imsunil/projects/unboxedkart/development/user/server/src/s3/s3.controller.ts", "TypeScript", 0, 0, 0, 0, 6, 0, 2, 8
"/Users/imsunil/projects/unboxedkart/development/user/server/src/s3/s3.module.ts", "TypeScript", 0, 0, 0, 0, 8, 0, 2, 10
"/Users/imsunil/projects/unboxedkart/development/user/server/src/s3/s3.service.spec.ts", "TypeScript", 0, 0, 0, 0, 14, 0, 5, 19
"/Users/imsunil/projects/unboxedkart/development/user/server/src/s3/s3.service.ts", "TypeScript", 0, 0, 0, 0, 93, 15, 12, 120
"/Users/imsunil/projects/unboxedkart/development/user/server/src/search/dto/add-search-term.dto.ts", "TypeScript", 0, 0, 0, 0, 6, 0, 2, 8
"/Users/imsunil/projects/unboxedkart/development/user/server/src/search/search.controller.ts", "TypeScript", 0, 0, 0, 0, 104, 13, 9, 126
"/Users/imsunil/projects/unboxedkart/development/user/server/src/search/search.module.ts", "TypeScript", 0, 0, 0, 0, 20, 0, 2, 22
"/Users/imsunil/projects/unboxedkart/development/user/server/src/search/search.service.ts", "TypeScript", 0, 0, 0, 0, 135, 18, 8, 161
"/Users/imsunil/projects/unboxedkart/development/user/server/src/service/dto/create-service.dto.ts", "TypeScript", 0, 0, 0, 0, 33, 0, 13, 46
"/Users/imsunil/projects/unboxedkart/development/user/server/src/service/dto/update-service.dto.ts", "TypeScript", 0, 0, 0, 0, 3, 0, 2, 5
"/Users/imsunil/projects/unboxedkart/development/user/server/src/service/service.controller.ts", "TypeScript", 0, 0, 0, 0, 54, 0, 7, 61
"/Users/imsunil/projects/unboxedkart/development/user/server/src/service/service.module.ts", "TypeScript", 0, 0, 0, 0, 26, 0, 2, 28
"/Users/imsunil/projects/unboxedkart/development/user/server/src/service/service.service.ts", "TypeScript", 0, 0, 0, 0, 80, 0, 9, 89
"/Users/imsunil/projects/unboxedkart/development/user/server/src/services/dto/create-service.dto.ts", "TypeScript", 0, 0, 0, 0, 1, 0, 1, 2
"/Users/imsunil/projects/unboxedkart/development/user/server/src/services/dto/update-service.dto.ts", "TypeScript", 0, 0, 0, 0, 3, 0, 2, 5
"/Users/imsunil/projects/unboxedkart/development/user/server/src/services/services.controller.spec.ts", "TypeScript", 0, 0, 0, 0, 16, 0, 5, 21
"/Users/imsunil/projects/unboxedkart/development/user/server/src/services/services.controller.ts", "TypeScript", 0, 0, 0, 0, 45, 0, 8, 53
"/Users/imsunil/projects/unboxedkart/development/user/server/src/services/services.module.ts", "TypeScript", 0, 0, 0, 0, 13, 0, 2, 15
"/Users/imsunil/projects/unboxedkart/development/user/server/src/services/services.service.spec.ts", "TypeScript", 0, 0, 0, 0, 14, 0, 5, 19
"/Users/imsunil/projects/unboxedkart/development/user/server/src/services/services.service.ts", "TypeScript", 0, 0, 0, 0, 105, 0, 8, 113
"/Users/imsunil/projects/unboxedkart/development/user/server/src/store-api/models/store-notification.model.ts", "TypeScript", 0, 0, 0, 0, 31, 0, 3, 34
"/Users/imsunil/projects/unboxedkart/development/user/server/src/store-api/token/dto/cancel-order.dto.ts", "TypeScript", 0, 0, 0, 0, 15, 0, 5, 20
"/Users/imsunil/projects/unboxedkart/development/user/server/src/store-api/token/dto/create-token.dto.ts", "TypeScript", 0, 0, 0, 0, 48, 0, 17, 65
"/Users/imsunil/projects/unboxedkart/development/user/server/src/store-api/token/store-token.controller.ts", "TypeScript", 0, 0, 0, 0, 42, 10, 4, 56
"/Users/imsunil/projects/unboxedkart/development/user/server/src/store-api/token/store-token.module.ts", "TypeScript", 0, 0, 0, 0, 31, 10, 2, 43
"/Users/imsunil/projects/unboxedkart/development/user/server/src/store-api/token/store-token.service.ts", "TypeScript", 0, 0, 0, 0, 46, 1, 4, 51
"/Users/imsunil/projects/unboxedkart/development/user/server/src/store-location/store-location.controller.ts", "TypeScript", 0, 0, 0, 0, 11, 0, 3, 14
"/Users/imsunil/projects/unboxedkart/development/user/server/src/store-location/store-location.module.ts", "TypeScript", 0, 0, 0, 0, 16, 0, 2, 18
"/Users/imsunil/projects/unboxedkart/development/user/server/src/store-location/store-location.service.ts", "TypeScript", 0, 0, 0, 0, 15, 0, 5, 20
"/Users/imsunil/projects/unboxedkart/development/user/server/src/usage-tracking/dtos/add-cart-item.dto.ts", "TypeScript", 0, 0, 0, 0, 6, 0, 2, 8
"/Users/imsunil/projects/unboxedkart/development/user/server/src/usage-tracking/dtos/add-searched-term.dto.ts", "TypeScript", 0, 0, 0, 0, 6, 0, 2, 8
"/Users/imsunil/projects/unboxedkart/development/user/server/src/usage-tracking/dtos/add-viewed-product.dto.ts", "TypeScript", 0, 0, 0, 0, 6, 0, 2, 8
"/Users/imsunil/projects/unboxedkart/development/user/server/src/usage-tracking/dtos/add-wishlist-item.dto.ts", "TypeScript", 0, 0, 0, 0, 6, 0, 2, 8
"/Users/imsunil/projects/unboxedkart/development/user/server/src/usage-tracking/dtos/clicked-on-buy-now.dto.ts", "TypeScript", 0, 0, 0, 0, 6, 0, 2, 8
"/Users/imsunil/projects/unboxedkart/development/user/server/src/usage-tracking/dtos/clicked-on-need-more-discount.dto.ts", "TypeScript", 0, 0, 0, 0, 6, 0, 2, 8
"/Users/imsunil/projects/unboxedkart/development/user/server/src/usage-tracking/dtos/remove-cart-item.dto.ts", "TypeScript", 0, 0, 0, 0, 6, 0, 2, 8
"/Users/imsunil/projects/unboxedkart/development/user/server/src/usage-tracking/dtos/remove-wishlist-item.dto.ts", "TypeScript", 0, 0, 0, 0, 6, 0, 2, 8
"/Users/imsunil/projects/unboxedkart/development/user/server/src/usage-tracking/usage-tracking.controller.ts", "TypeScript", 0, 0, 0, 0, 114, 23, 15, 152
"/Users/imsunil/projects/unboxedkart/development/user/server/src/usage-tracking/usage-tracking.module.ts", "TypeScript", 0, 0, 0, 0, 24, 0, 2, 26
"/Users/imsunil/projects/unboxedkart/development/user/server/src/usage-tracking/usage-tracking.service.ts", "TypeScript", 0, 0, 0, 0, 134, 0, 13, 147
"/Users/imsunil/projects/unboxedkart/development/user/server/src/user/dto/update-user-details.dto.ts", "TypeScript", 0, 0, 0, 0, 9, 3, 4, 16
"/Users/imsunil/projects/unboxedkart/development/user/server/src/user/dto/update-user-payment-details.dto.ts", "TypeScript", 0, 0, 0, 0, 9, 3, 5, 17
"/Users/imsunil/projects/unboxedkart/development/user/server/src/user/user.controller.ts", "TypeScript", 0, 0, 0, 0, 54, 0, 7, 61
"/Users/imsunil/projects/unboxedkart/development/user/server/src/user/user.module.ts", "TypeScript", 0, 0, 0, 0, 18, 0, 2, 20
"/Users/imsunil/projects/unboxedkart/development/user/server/src/user/user.service.ts", "TypeScript", 0, 0, 0, 0, 73, 4, 8, 85
"/Users/imsunil/projects/unboxedkart/development/user/server/src/variants/variants.controller.spec.ts", "TypeScript", 0, 0, 0, 0, 16, 0, 5, 21
"/Users/imsunil/projects/unboxedkart/development/user/server/src/variants/variants.controller.ts", "TypeScript", 0, 0, 0, 0, 16, 0, 4, 20
"/Users/imsunil/projects/unboxedkart/development/user/server/src/variants/variants.module.ts", "TypeScript", 0, 0, 0, 0, 15, 0, 2, 17
"/Users/imsunil/projects/unboxedkart/development/user/server/src/variants/variants.service.spec.ts", "TypeScript", 0, 0, 0, 0, 14, 0, 5, 19
"/Users/imsunil/projects/unboxedkart/development/user/server/src/variants/variants.service.ts", "TypeScript", 0, 0, 0, 0, 36, 7, 4, 47
"/Users/imsunil/projects/unboxedkart/development/user/server/test/app.e2e-spec.ts", "TypeScript", 0, 0, 0, 0, 20, 0, 5, 25
"/Users/imsunil/projects/unboxedkart/development/user/server/test/jest-e2e.json", "JSON", 0, 9, 0, 0, 0, 0, 1, 10
"/Users/imsunil/projects/unboxedkart/development/user/server/tsconfig.build.json", "JSON", 0, 3, 0, 0, 0, 2, 0, 5
"/Users/imsunil/projects/unboxedkart/development/user/server/tsconfig.json", "JSON with Comments", 0, 0, 21, 0, 0, 0, 1, 22
"Total", "-", 11857, 20309, 21, 51, 11491, 2218, 1408, 47355